ATCTCTGACCGGATAATAACTTCA -> TCTCTGACCGGATAATAACTTCAC
CTTTCATCTGAGTCAGCGTGTCTT -> TTTCATCTGAGTCAGCGTGTCTTT
CGCACGGTCCTCCTACCTATGCCG -> GCACGGTCCTCCTACCTATGCCGG
GCAGTTAATATATTCGGGCGTGGG -> CAGTTAATATATTCGGGCGTGGGA
ATTTCTCGTGGCCTAGACGTGGTA -> TTTCTCGTGGCCTAGACGTGGTAG
CGTGGCCTAGACGTGGTAGATTCA -> GTGGCCTAGACGTGGTAGATTCAT
CTCCGTCCATAGTCTGACAGGTGG -> TCCGTCCATAGTCTGACAGGTGGC
AGTACTGGTAACTGTTTGGCCTAT -> GTACTGGTAACTGTTTGGCCTATT
TCAAAGCAAATCCCTATAGCCCAT -> CAAAGCAAATCCCTATAGCCCATC
TTCGAGAAGGGAGCATTTTCAGAT -> TCGAGAAGGGAGCATTTTCAGATT
AACTAAGTACTGGTAACTGTTTGG -> ACTAAGTACTGGTAACTGTTTGGC
TAAAGGGTTCACGCCGTGGACACT -> AAAGGGTTCACGCCGTGGACACTT
CATGTCCGGGGAGATTGCCTCTTT -> ATGTCCGGGGAGATTGCCTCTTTG
AGCTACTAAAGAACCAGGTCAGCC -> GCTACTAAAGAACCAGGTCAGCCG
AGCAATGTGGCTCTTCTATTTGAG -> GCAATGTGGCTCTTCTATTTGAGG
ATTCATGACCATTTCGTTGTATGA -> TTCATGACCATTTCGTTGTATGAG
AGGGAAATAACTATAGTGAGGTAC -> GGGAAATAACTATAGTGAGGTACG
CTACTGCCATGTTTGCTTCTCAGG -> TACTGCCATGTTTGCTTCTCAGGT
CGTTGCACCAGACGTTCATGCCCT -> GTTGCACCAGACGTTCATGCCCTG
CGGATAATAACTTCACCCTAGGGT -> GGATAATAACTTCACCCTAGGGTC
CCAAGAGCTTTCATCTGAGTCAGC -> CAAGAGCTTTCATCTGAGTCAGCG
CAGCATCGAATTAATTGTGCCGAG -> AGCATCGAATTAATTGTGCCGAGC
TAAGGGGAGCTCGCTAAGCCCTCC -> AAGGGGAGCTCGCTAAGCCCTCCC
GGTGGCAGCTTTGAGCGCACAGAA -> GTGGCAGCTTTGAGCGCACAGAAA
AGTGCTAGCGATAGGTCATCAAGA -> GTGCTAGCGATAGGTCATCAAGAA
CCTGTGAGACAGTGGCCTATAACG -> CTGTGAGACAGTGGCCTATAACGC
ACCTCTGGGCGCCCCTCCCAAAAG -> CCTCTGGGCGCCCCTCCCAAAAGT
ATTGTCTGTTAAGGGGAGCTCGCT -> TTGTCTGTTAAGGGGAGCTCGCTA
TGCAAACACAATGAGCGCTGCTTC -> GCAAACACAATGAGCGCTGCTTCC
CCATCCCCCTATCCGGACAACTGT -> CATCCCCCTATCCGGACAACTGTA
GCTCACCATTGAAGTAGAATAATC -> CTCACCATTGAAGTAGAATAATCA
GTTCGAGAAGGGAGCATTTTCAGA -> TTCGAGAAGGGAGCATTTTCAGAT
GTCTTTCTAAAATTCGTCTTCGGG -> TCTTTCTAAAATTCGTCTTCGGGC
ACGATGGGATCTCAAAGCAAATCC -> CGATGGGATCTCAAAGCAAATCCC
AGCACTAGTAGTCCCTCGCACAGG -> GCACTAGTAGTCCCTCGCACAGGT
ACTACCCTCTTAAGCTACTAAAGA -> CTACCCTCTTAAGCTACTAAAGAA
GTGGACACTTGCTACTGCCATGTT -> TGGACACTTGCTACTGCCATGTTT
AGTAAACCTCGCGTTGTCTGCTAG -> GTAAACCTCGCGTTGTCTGCTAGT
GTAACTTACGAGGAACTATACGGG -> TAACTTACGAGGAACTATACGGGC
CCAGGTCAGCCGACAATGCCCCAT -> CAGGTCAGCCGACAATGCCCCATG
TCGTTGTATGAGACCGTGCGATGC -> CGTTGTATGAGACCGTGCGATGCG
CTCTCACTTGATTAAATCCAGAAC -> TCTCACTTGATTAAATCCAGAACC
TATGAATGTCCATACATGCATTAA -> ATGAATGTCCATACATGCATTAAA
AACGTTTGGCTCTATTGTCTGTTA -> ACGTTTGGCTCTATTGTCTGTTAA
CGTGGGAACGTTGTCTATTGGCAC -> GTGGGAACGTTGTCTATTGGCACC
TCCCACCATCGTTATAAATGAAAG -> CCCACCATCGTTATAAATGAAAGG
TGCCGGCGCCGCCCGGGCCCGGCA -> GCCGGCGCCGCCCGGGCCCGGCAA
ACGTTGTAAATCACTGCAGCGCTG -> CGTTGTAAATCACTGCAGCGCTGC
AAATCCCTATAGCCCATCAGAACG -> AATCCCTATAGCCCATCAGAACGA
GGCCTCTTGAAAATTAAAGGGTTC -> GCCTCTTGAAAATTAAAGGGTTCA
CGGGCTAGTAAACTGCGAAATAAA -> GGGCTAGTAAACTGCGAAATAAAC
AGTAGCAACGTTTGGCTCTATTGT -> GTAGCAACGTTTGGCTCTATTGTC
CTAGTGAGCTCTTACGCTTAATCC -> TAGTGAGCTCTTACGCTTAATCCC
GGCACCGAATACCGAACATTGCGA -> GCACCGAATACCGAACATTGCGAC
TCCGATCTCTCACTTGATTAAATC -> CCGATCTCTCACTTGATTAAATCC
TTAATCTATGAATGTCCATACATG -> TAATCTATGAATGTCCATACATGC
TTGGCGCCAAGAGCTTTCATCTGA -> TGGCGCCAAGAGCTTTCATCTGAG
GAATAATCAATACGGGGGAATTCG -> AATAATCAATACGGGGGAATTCGT
CGCCCCTCCCAAAAGTCTTAGACA -> GCCCCTCCCAAAAGTCTTAGACAG
GTAGAATAATCAATACGGGGGAAT -> TAGAATAATCAATACGGGGGAATT
CGAATACCGAACATTGCGACAGTG -> GAATACCGAACATTGCGACAGTGA
ACACTTGCTACTGCCATGTTTGCT -> CACTTGCTACTGCCATGTTTGCTT
TATACAGATTTGTGAGCACTAGTA -> ATACAGATTTGTGAGCACTAGTAG
GCACACACGTTTTACAGGTCGATA -> CACACACGTTTTACAGGTCGATAC
TTGATAAGTCGTTGCACCAGACGT -> TGATAAGTCGTTGCACCAGACGTT
GGATATACAGATTTGTGAGCACTA -> GATATACAGATTTGTGAGCACTAG
GATAGGTCATCAAGAAAGGCCCAG -> ATAGGTCATCAAGAAAGGCCCAGT
TGTCATCTCTGACCGGATAATAAC -> GTCATCTCTGACCGGATAATAACT
CAATGTCATCTCTGACCGGATAAT -> AATGTCATCTCTGACCGGATAATA
AAGGCCCAGTGCAAGGGCACACAC -> AGGCCCAGTGCAAGGGCACACACG
AAATTGCTCGAAACTAAGTACTGG -> AATTGCTCGAAACTAAGTACTGGT
TGTCCAATGTCATCTCTGACCGGA -> GTCCAATGTCATCTCTGACCGGAT
GCCTTTCGGTCTACATGTCCGGGG -> CCTTTCGGTCTACATGTCCGGGGA
AAAGGGAAATAACTATAGTGAGGT -> AAGGGAAATAACTATAGTGAGGTA
GGTAGATTCATGACCATTTCGTTG -> GTAGATTCATGACCATTTCGTTGT
AGAAGGGAGCATTTTCAGATTGCT -> GAAGGGAGCATTTTCAGATTGCTT
AACTCAATGAGGAATAGGCGCTGA -> ACTCAATGAGGAATAGGCGCTGAG
CATGCCCTGGTGGCAGCTTTGAGC -> ATGCCCTGGTGGCAGCTTTGAGCG
CCTCTTAAGCTACTAAAGAACCAG -> CTCTTAAGCTACTAAAGAACCAGG
TTGGGAAGTTAGAGATGGCTCTCA -> TGGGAAGTTAGAGATGGCTCTCAC
CTCGCTAAGCCCTCCCCCTGAGGT -> TCGCTAAGCCCTCCCCCTGAGGTT
CACCATCGTTATAAATGAAAGGGA -> ACCATCGTTATAAATGAAAGGGAT
TGCAAGGGCACACACGTTTTACAG -> GCAAGGGCACACACGTTTTACAGG
ACGCTACTACGGTAGCTCACCATT -> CGCTACTACGGTAGCTCACCATTG
TGAGAAAGTTTGGAGTCAGAGAAT -> GAGAAAGTTTGGAGTCAGAGAATT
TAGTAAACTGCGAAATAAACTGCG -> AGTAAACTGCGAAATAAACTGCGG
AGAACCCTGAATAACAGGGCACTG -> GAACCCTGAATAACAGGGCACTGC
CCGTGCGATGCGCATCGGAGTCAG -> CGTGCGATGCGCATCGGAGTCAGC
TGTCCGGGGAGATTGCCTCTTTGC -> GTCCGGGGAGATTGCCTCTTTGCC
GGTAACTGTTTGGCCTATTGGCGC -> GTAACTGTTTGGCCTATTGGCGCC
AGTCTGAGAAAGTTTGGAGTCAGA -> GTCTGAGAAAGTTTGGAGTCAGAG
TCTGTTAGGTACACCTTCTCTTGT -> CTGTTAGGTACACCTTCTCTTGTT
TTTGTGAGCACTAGTAGTCCCTCG -> TTGTGAGCACTAGTAGTCCCTCGC
ATTAAATCCAGAACCCTGAATAAC -> TTAAATCCAGAACCCTGAATAACA
CAGGTCGATACGCGGCTTTTGGAT -> AGGTCGATACGCGGCTTTTGGATA
CATACATGCATTAAACTAACTCAA -> ATACATGCATTAAACTAACTCAAT
ATCCCCCTATCCGGACAACTGTAA -> TCCCCCTATCCGGACAACTGTAAC
AGCACCTTGACGCGAGCTGTACTG -> GCACCTTGACGCGAGCTGTACTGT
TGGGAACGTTGTCTATTGGCACCG -> GGGAACGTTGTCTATTGGCACCGA
TTTGGATATACAGATTTGTGAGCA -> TTGGATATACAGATTTGTGAGCAC
TCAGAACGAGACGAGGATAGTGCT -> CAGAACGAGACGAGGATAGTGCTT
GTTGCACCAGACGTTCATGCCCTG -> TTGCACCAGACGTTCATGCCCTGG
ACCGATACTATCAAATTCCGATCT -> CCGATACTATCAAATTCCGATCTC
GCTCAACGCGGTCTTTCTAAAATT -> CTCAACGCGGTCTTTCTAAAATTC
GTGGCTCAGGTAACTTACGAGGAA -> TGGCTCAGGTAACTTACGAGGAAC
ATCTGAGTCAGCGTGTCTTTTTGA -> TCTGAGTCAGCGTGTCTTTTTGAT
TCGGGCCTTTCGGTCTACATGTCC -> CGGGCCTTTCGGTCTACATGTCCG
CCTGGTGGCAGCTTTGAGCGCACA -> CTGGTGGCAGCTTTGAGCGCACAG
TATAAATGAAAGGGATCTGAGACG -> ATAAATGAAAGGGATCTGAGACGC
GGGTCGACCTCTGGGCGCCCCTCC -> GGTCGACCTCTGGGCGCCCCTCCC
GCCTATTGGCGCCAAGAGCTTTCA -> CCTATTGGCGCCAAGAGCTTTCAT
AATTACGTATGACACTCACATTGC -> ATTACGTATGACACTCACATTGCC
GGCCCCCCAACTCCGGGTCCTGCT -> GCCCCCCAACTCCGGGTCCTGCTA
TAGTCCCTCGCACAGGTACTCTTA -> AGTCCCTCGCACAGGTACTCTTAG
TAGGTCATCAAGAAAGGCCCAGTG -> AGGTCATCAAGAAAGGCCCAGTGC
GAATTAATTGTGCCGAGCGACAGC -> AATTAATTGTGCCGAGCGACAGCG
CTAGACGTGGTAGATTCATGACCA -> TAGACGTGGTAGATTCATGACCAT
TGGCCTATTGGCGCCAAGAGCTTT -> GGCCTATTGGCGCCAAGAGCTTTC
CCAACTCCGGGTCCTGCTAGGGAT -> CAACTCCGGGTCCTGCTAGGGATC
TATTTGAGGCAGACTAAGCCCGGG -> ATTTGAGGCAGACTAAGCCCGGGT
GAACGTTGTCTATTGGCACCGAAT -> AACGTTGTCTATTGGCACCGAATA
AGGGATCAGACGATGGGATCTCAA -> GGGATCAGACGATGGGATCTCAAA
CTCTGGGCGCCCCTCCCAAAAGTC -> TCTGGGCGCCCCTCCCAAAAGTCT
TTGCGACAGTGATAGTAAACCTCG -> TGCGACAGTGATAGTAAACCTCGC
CGACGCTACTACGGTAGCTCACCA -> GACGCTACTACGGTAGCTCACCAT
TTGCTCGAAACTAAGTACTGGTAA -> TGCTCGAAACTAAGTACTGGTAAC
CTAAAATTCGTCTTCGGGCCTTTC -> TAAAATTCGTCTTCGGGCCTTTCG
TACGGGGGAATTCGTCAAAAGAAA -> ACGGGGGAATTCGTCAAAAGAAAA
TCTCTGACCGGATAATAACTTCAC -> CTCTGACCGGATAATAACTTCACC
TGATTAAATCCAGAACCCTGAATA -> GATTAAATCCAGAACCCTGAATAA
GTAACTGTTTGGCCTATTGGCGCC -> TAACTGTTTGGCCTATTGGCGCCA
AAGTTTGGAGTCAGAGAATTACGT -> AGTTTGGAGTCAGAGAATTACGTA
TCGGTCTACATGTCCGGGGAGATT -> CGGTCTACATGTCCGGGGAGATTG
GTAGATTCATGACCATTTCGTTGT -> TAGATTCATGACCATTTCGTTGTA
CACTGTCCAATGTCATCTCTGACC -> ACTGTCCAATGTCATCTCTGACCG
CAGTGGCCTATAACGCACGGTCCT -> AGTGGCCTATAACGCACGGTCCTC
ACACAATGAGCGCTGCTTCCCTCC -> CACAATGAGCGCTGCTTCCCTCCG
GACACTCACATTGCCGGAACTATA -> ACACTCACATTGCCGGAACTATAG
TCCCCCTATCCGGACAACTGTAAC -> CCCCCTATCCGGACAACTGTAACC
GAGTGGAGGGGGCTCTTGGGAAGT -> AGTGGAGGGGGCTCTTGGGAAGTT
TAGTCTGACAGGTGGCTCAGGTAA -> AGTCTGACAGGTGGCTCAGGTAAC
CGGGTTACCAAGTTGCTCAACGCG -> GGGTTACCAAGTTGCTCAACGCGG
AGGTACGAAAGTGCTAGCGATAGG -> GGTACGAAAGTGCTAGCGATAGGT
CTACCCTCTTAAGCTACTAAAGAA -> TACCCTCTTAAGCTACTAAAGAAC
ACTATCAAATTCCGATCTCTCACT -> CTATCAAATTCCGATCTCTCACTT
CAGTCTGAGAAAGTTTGGAGTCAG -> AGTCTGAGAAAGTTTGGAGTCAGA
TCACCATTGAAGTAGAATAATCAA -> CACCATTGAAGTAGAATAATCAAT
CCCTGAATAACAGGGCACTGCGCA -> CCTGAATAACAGGGCACTGCGCAG
GGCCTATTGGCGCCAAGAGCTTTC -> GCCTATTGGCGCCAAGAGCTTTCA
ATACGGGCCAACGCCGCGTAATCA -> TACGGGCCAACGCCGCGTAATCAT
ATTGCCTCTTTGCCGGCGCCGCCC -> TTGCCTCTTTGCCGGCGCCGCCCG
AGCGAAGCAGTTAATATATTCGGG -> GCGAAGCAGTTAATATATTCGGGC
CAGAGTAGCAACGTTTGGCTCTAT -> AGAGTAGCAACGTTTGGCTCTATT
TTTGCCGGCGCCGCCCGGGCCCGG -> TTGCCGGCGCCGCCCGGGCCCGGC
ATGGCTCTCACTGTCCAATGTCAT -> TGGCTCTCACTGTCCAATGTCATC
TCACCTTAATTAATGCACAGTCTG -> CACCTTAATTAATGCACAGTCTGA
CGACAGTGATAGTAAACCTCGCGT -> GACAGTGATAGTAAACCTCGCGTT
TACGTATGACACTCACATTGCCGG -> ACGTATGACACTCACATTGCCGGA
AATAACAGGGCACTGCGCAGAATC -> ATAACAGGGCACTGCGCAGAATCC
GAGTCAGCGTGTCTTTTTGATAAG -> AGTCAGCGTGTCTTTTTGATAAGT
AACATTGCGACAGTGATAGTAAAC -> ACATTGCGACAGTGATAGTAAACC
CCGCGTAATCATAGGACGTTGTAA -> CGCGTAATCATAGGACGTTGTAAA
TCATCTCTGACCGGATAATAACTT -> CATCTCTGACCGGATAATAACTTC
GGCTCTTGGGAAGTTAGAGATGGC -> GCTCTTGGGAAGTTAGAGATGGCT
TGAGACAGTGGCCTATAACGCACG -> GAGACAGTGGCCTATAACGCACGG
CGCTACTACGGTAGCTCACCATTG -> GCTACTACGGTAGCTCACCATTGA
TTTTGATAAGTCGTTGCACCAGAC -> TTTGATAAGTCGTTGCACCAGACG
TGCGCATCGGAGTCAGCATCGAAT -> GCGCATCGGAGTCAGCATCGAATT
TACTGTGCCGCCGGCATACGTCCT -> ACTGTGCCGCCGGCATACGTCCTG
CAGTGATAGTAAACCTCGCGTTGT -> AGTGATAGTAAACCTCGCGTTGTC
TTACGAGGAACTATACGGGCCAAC -> TACGAGGAACTATACGGGCCAACG
ATGCCCGAGTGACGGGCTAGTAAA -> TGCCCGAGTGACGGGCTAGTAAAC
CTTGAAAATTAAAGGGTTCACGCC -> TTGAAAATTAAAGGGTTCACGCCG
GACCGTGCGATGCGCATCGGAGTC -> ACCGTGCGATGCGCATCGGAGTCA
TTGATTAAATCCAGAACCCTGAAT -> TGATTAAATCCAGAACCCTGAATA
TTTGGAGTCAGAGAATTACGTATG -> TTGGAGTCAGAGAATTACGTATGA
GTCCAATGTCATCTCTGACCGGAT -> TCCAATGTCATCTCTGACCGGATA
TCGGAGTCAGCATCGAATTAATTG -> CGGAGTCAGCATCGAATTAATTGT
TCGAATTAATTGTGCCGAGCGACA -> CGAATTAATTGTGCCGAGCGACAG
TCCAATGTCATCTCTGACCGGATA -> CCAATGTCATCTCTGACCGGATAA
TAAGTACTGGTAACTGTTTGGCCT -> AAGTACTGGTAACTGTTTGGCCTA
GTCAACCATCCCCCTATCCGGACA -> TCAACCATCCCCCTATCCGGACAA
CTAGCGATAGGTCATCAAGAAAGG -> TAGCGATAGGTCATCAAGAAAGGC
ATCAATACGGGGGAATTCGTCAAA -> TCAATACGGGGGAATTCGTCAAAA
CAGCGTGTCTTTTTGATAAGTCGT -> AGCGTGTCTTTTTGATAAGTCGTT
TACAGATTTGTGAGCACTAGTAGT -> ACAGATTTGTGAGCACTAGTAGTC
TTGCCGGAACTATAGGAATAGAGT -> TGCCGGAACTATAGGAATAGAGTT
ACTAAGCCCGGGTTACCAAGTTGC -> CTAAGCCCGGGTTACCAAGTTGCT
ACCAAAACCGATACTATCAAATTC -> CCAAAACCGATACTATCAAATTCC
TTTTGCAAACACAATGAGCGCTGC -> TTTGCAAACACAATGAGCGCTGCT
CCAAAACCGATACTATCAAATTCC -> CAAAACCGATACTATCAAATTCCG
CCCATGCCCTCGAGTGGAGGGGGC -> CCATGCCCTCGAGTGGAGGGGGCT
GAGCATTTTCAGATTGCTTGTTTC -> AGCATTTTCAGATTGCTTGTTTCA
TTAAACTAACTCAATGAGGAATAG -> TAAACTAACTCAATGAGGAATAGG
AGTCGACGCTACTACGGTAGCTCA -> GTCGACGCTACTACGGTAGCTCAC
AGACGAGGATAGTGCTTTATCTGT -> GACGAGGATAGTGCTTTATCTGTT
CGTCCTGTGAGACAGTGGCCTATA -> GTCCTGTGAGACAGTGGCCTATAA
TTGCCGGCGCCGCCCGGGCCCGGC -> TGCCGGCGCCGCCCGGGCCCGGCA
TACGCGGCTTTTGGATATACAGAT -> ACGCGGCTTTTGGATATACAGATT
CTCACATTGCCGGAACTATAGGAA -> TCACATTGCCGGAACTATAGGAAT
GCATTAAACTAACTCAATGAGGAA -> CATTAAACTAACTCAATGAGGAAT
TGGAGTCAGAGAATTACGTATGAC -> GGAGTCAGAGAATTACGTATGACA
CAAGAAAGGCCCAGTGCAAGGGCA -> AAGAAAGGCCCAGTGCAAGGGCAC
TGTACTGTGCCGCCGGCATACGTC -> GTACTGTGCCGCCGGCATACGTCC
TGGGATCTCAAAGCAAATCCCTAT -> GGGATCTCAAAGCAAATCCCTATA
GGTAGCTCACCATTGAAGTAGAAT -> GTAGCTCACCATTGAAGTAGAATA
CAGCAATGTGGCTCTTCTATTTGA -> AGCAATGTGGCTCTTCTATTTGAG
GCGCTGCTTCCCTCCGTCCATAGT -> CGCTGCTTCCCTCCGTCCATAGTC
TCTTCGGGCCTTTCGGTCTACATG -> CTTCGGGCCTTTCGGTCTACATGT
GCGGTCTTTCTAAAATTCGTCTTC -> CGGTCTTTCTAAAATTCGTCTTCG
AATCCCACCATCGTTATAAATGAA -> ATCCCACCATCGTTATAAATGAAA
GAGCTGTACTGTGCCGCCGGCATA -> AGCTGTACTGTGCCGCCGGCATAC
GCGAAGCAGTTAATATATTCGGGC -> CGAAGCAGTTAATATATTCGGGCG
AGAAAGGCCCAGTGCAAGGGCACA -> GAAAGGCCCAGTGCAAGGGCACAC
GCTTAATCCCACCATCGTTATAAA -> CTTAATCCCACCATCGTTATAAAT
GATCTCAAAGCAAATCCCTATAGC -> ATCTCAAAGCAAATCCCTATAGCC
CACCGAATACCGAACATTGCGACA -> ACCGAATACCGAACATTGCGACAG
CAATGCCCCATGCCCTCGAGTGGA -> AATGCCCCATGCCCTCGAGTGGAG
CGAGACGAGGATAGTGCTTTATCT -> GAGACGAGGATAGTGCTTTATCTG
AATGAGCGCTGCTTCCCTCCGTCC -> ATGAGCGCTGCTTCCCTCCGTCCA
GCCCCCCAACTCCGGGTCCTGCTA -> CCCCCCAACTCCGGGTCCTGCTAG
CCCTGAGGTTGAAAAATTGCTCGA -> CCTGAGGTTGAAAAATTGCTCGAA
AAAGGCCCAGTGCAAGGGCACACA -> AAGGCCCAGTGCAAGGGCACACAC
TATTTTGCAAACACAATGAGCGCT -> ATTTTGCAAACACAATGAGCGCTG
AGCTTTCATCTGAGTCAGCGTGTC -> GCTTTCATCTGAGTCAGCGTGTCT
CTCCCCCTGAGGTTGAAAAATTGC -> TCCCCCTGAGGTTGAAAAATTGCT
GCTTCTCAGGTACGCTATATTTTG -> CTTCTCAGGTACGCTATATTTTGC
AGTGAGCTCTTACGCTTAATCCCA -> GTGAGCTCTTACGCTTAATCCCAC
ACTATACGGGCCAACGCCGCGTAA -> CTATACGGGCCAACGCCGCGTAAT
CATGTTTGCTTCTCAGGTACGCTA -> ATGTTTGCTTCTCAGGTACGCTAT
GTACGCTATATTTTGCAAACACAA -> TACGCTATATTTTGCAAACACAAT
TGTCCATACATGCATTAAACTAAC -> GTCCATACATGCATTAAACTAACT
AGTCTTAGACAGAGTAGCAACGTT -> GTCTTAGACAGAGTAGCAACGTTT
ATGACACTCACATTGCCGGAACTA -> TGACACTCACATTGCCGGAACTAT
CCGGATAATAACTTCACCCTAGGG -> CGGATAATAACTTCACCCTAGGGT
TAATCAATACGGGGGAATTCGTCA -> AATCAATACGGGGGAATTCGTCAA
TGTGAGCACTAGTAGTCCCTCGCA -> GTGAGCACTAGTAGTCCCTCGCAC
CATCAGAACGAGACGAGGATAGTG -> ATCAGAACGAGACGAGGATAGTGC
CCCCCTATCCGGACAACTGTAACC -> CCCCTATCCGGACAACTGTAACCA
GAAGTTAGAGATGGCTCTCACTGT -> AAGTTAGAGATGGCTCTCACTGTC
TGACCGGATAATAACTTCACCCTA -> GACCGGATAATAACTTCACCCTAG
CGAACATTGCGACAGTGATAGTAA -> GAACATTGCGACAGTGATAGTAAA
GGACGTTGTAAATCACTGCAGCGC -> GACGTTGTAAATCACTGCAGCGCT
TGCCCCATGCCCTCGAGTGGAGGG -> GCCCCATGCCCTCGAGTGGAGGGG
CTGAGGTTGAAAAATTGCTCGAAA -> TGAGGTTGAAAAATTGCTCGAAAC
ACTTGCTACTGCCATGTTTGCTTC -> CTTGCTACTGCCATGTTTGCTTCT
TGGCCTAGACGTGGTAGATTCATG -> GGCCTAGACGTGGTAGATTCATGA
CAGCGAAGCAGTTAATATATTCGG -> AGCGAAGCAGTTAATATATTCGGG
CTCCGAAATTTGTTATCCGGATTG -> TCCGAAATTTGTTATCCGGATTGA
CCCTATAGCCCATCAGAACGAGAC -> CCTATAGCCCATCAGAACGAGACG
TCTTAGCACCTTGACGCGAGCTGT -> CTTAGCACCTTGACGCGAGCTGTA
CTTCGGGCCTTTCGGTCTACATGT -> TTCGGGCCTTTCGGTCTACATGTC
TAAGCCCGGGTTACCAAGTTGCTC -> AAGCCCGGGTTACCAAGTTGCTCA
AGGTGGCTCAGGTAACTTACGAGG -> GGTGGCTCAGGTAACTTACGAGGA
GCCAAGAGCTTTCATCTGAGTCAG -> CCAAGAGCTTTCATCTGAGTCAGC
TGCTAGGGATCAGACGATGGGATC -> GCTAGGGATCAGACGATGGGATCT
TTGATCTCGCCGGTTCGAGAAGGG -> TGATCTCGCCGGTTCGAGAAGGGA
CTGCGAAATAAACTGCGGTCAACC -> TGCGAAATAAACTGCGGTCAACCA
ACTAAGTACTGGTAACTGTTTGGC -> CTAAGTACTGGTAACTGTTTGGCC
CGTCTTCGGGCCTTTCGGTCTACA -> GTCTTCGGGCCTTTCGGTCTACAT
CAGAACGAGACGAGGATAGTGCTT -> AGAACGAGACGAGGATAGTGCTTT
GGAGTCAGAGAATTACGTATGACA -> GAGTCAGAGAATTACGTATGACAC
GGCGCCAAGAGCTTTCATCTGAGT -> GCGCCAAGAGCTTTCATCTGAGTC
GCACCGAATACCGAACATTGCGAC -> CACCGAATACCGAACATTGCGACA
GCGCCCCTCCCAAAAGTCTTAGAC -> CGCCCCTCCCAAAAGTCTTAGACA
GTTTGGCCTATTGGCGCCAAGAGC -> TTTGGCCTATTGGCGCCAAGAGCT
GCCTATAACGCACGGTCCTCCTAC -> CCTATAACGCACGGTCCTCCTACC
GTCCGGGGAGATTGCCTCTTTGCC -> TCCGGGGAGATTGCCTCTTTGCCG
TTCTCTTGTTTGGCTCTAGACGGT -> TCTCTTGTTTGGCTCTAGACGGTA
GCACAGGTACTCTTAGCACCTTGA -> CACAGGTACTCTTAGCACCTTGAC
CACTAGTAGTCCCTCGCACAGGTA -> ACTAGTAGTCCCTCGCACAGGTAC
CTGCGCAGAATCCTGACGGCCCCC -> TGCGCAGAATCCTGACGGCCCCCC
GACGCTACTACGGTAGCTCACCAT -> ACGCTACTACGGTAGCTCACCATT
GATTGCCTCTTTGCCGGCGCCGCC -> ATTGCCTCTTTGCCGGCGCCGCCC
TCGTGGCCTAGACGTGGTAGATTC -> CGTGGCCTAGACGTGGTAGATTCA
GTGAGCTCTTACGCTTAATCCCAC -> TGAGCTCTTACGCTTAATCCCACC
GTGGCCTATAACGCACGGTCCTCC -> TGGCCTATAACGCACGGTCCTCCT
AGCGCACAGAAATATAGTCGACGC -> GCGCACAGAAATATAGTCGACGCT
GGGCCTTTCGGTCTACATGTCCGG -> GGCCTTTCGGTCTACATGTCCGGG
AACGCACGGTCCTCCTACCTATGC -> ACGCACGGTCCTCCTACCTATGCC
GTTACCAAGTTGCTCAACGCGGTC -> TTACCAAGTTGCTCAACGCGGTCT
ACGCGAGCTGTACTGTGCCGCCGG -> CGCGAGCTGTACTGTGCCGCCGGC
TTAGAGATGGCTCTCACTGTCCAA -> TAGAGATGGCTCTCACTGTCCAAT
CCCCCCAACTCCGGGTCCTGCTAG -> CCCCCAACTCCGGGTCCTGCTAGG
GTCTTCGGGCCTTTCGGTCTACAT -> TCTTCGGGCCTTTCGGTCTACATG
GCGACAGCGAAGCAGTTAATATAT -> CGACAGCGAAGCAGTTAATATATT
ACTTGATTAAATCCAGAACCCTGA -> CTTGATTAAATCCAGAACCCTGAA
GGTACACCTTCTCTTGTTTGGCTC -> GTACACCTTCTCTTGTTTGGCTCT
ACGTTCATGCCCTGGTGGCAGCTT -> CGTTCATGCCCTGGTGGCAGCTTT
ACTATAGTGAGGTACGAAAGTGCT -> CTATAGTGAGGTACGAAAGTGCTA
TCGGGCGTGGGAACGTTGTCTATT -> CGGGCGTGGGAACGTTGTCTATTG
CGAAATTTGTTATCCGGATTGATC -> GAAATTTGTTATCCGGATTGATCT
CTATTGGCACCGAATACCGAACAT -> TATTGGCACCGAATACCGAACATT
TCGCTAAGCCCTCCCCCTGAGGTT -> CGCTAAGCCCTCCCCCTGAGGTTG
GTCAGCATCGAATTAATTGTGCCG -> TCAGCATCGAATTAATTGTGCCGA
TGCGGTCAACCATCCCCCTATCCG -> GCGGTCAACCATCCCCCTATCCGG
TTACAGGTCGATACGCGGCTTTTG -> TACAGGTCGATACGCGGCTTTTGG
CGCCCGGGCCCGGCAAGGCCTCTT -> GCCCGGGCCCGGCAAGGCCTCTTG
GAATTACGTATGACACTCACATTG -> AATTACGTATGACACTCACATTGC
TACGTCCTGTGAGACAGTGGCCTA -> ACGTCCTGTGAGACAGTGGCCTAT
GCTGTACTGTGCCGCCGGCATACG -> CTGTACTGTGCCGCCGGCATACGT
GAAGCAGTTAATATATTCGGGCGT -> AAGCAGTTAATATATTCGGGCGTG
GTGGCAGCTTTGAGCGCACAGAAA -> TGGCAGCTTTGAGCGCACAGAAAT
TGATAGTAAACCTCGCGTTGTCTG -> GATAGTAAACCTCGCGTTGTCTGC
AAAAGTCTTAGACAGAGTAGCAAC -> AAAGTCTTAGACAGAGTAGCAACG
GAGGAACTATACGGGCCAACGCCG -> AGGAACTATACGGGCCAACGCCGC
TGAAAATTAAAGGGTTCACGCCGT -> GAAAATTAAAGGGTTCACGCCGTG
CAGGGCACTGCGCAGAATCCTGAC -> AGGGCACTGCGCAGAATCCTGACG
TTGTAAATCACTGCAGCGCTGCTA -> TGTAAATCACTGCAGCGCTGCTAC
GAGACAGTGGCCTATAACGCACGG -> AGACAGTGGCCTATAACGCACGGT
CCAAAAGTCTTAGACAGAGTAGCA -> CAAAAGTCTTAGACAGAGTAGCAA
CCCACCATCGTTATAAATGAAAGG -> CCACCATCGTTATAAATGAAAGGG
GTAAACCTCGCGTTGTCTGCTAGT -> TAAACCTCGCGTTGTCTGCTAGTG
GATCTGAGACGCAGCAATGTGGCT -> ATCTGAGACGCAGCAATGTGGCTC
GAAAGTGCTAGCGATAGGTCATCA -> AAAGTGCTAGCGATAGGTCATCAA
GACAGCGAAGCAGTTAATATATTC -> ACAGCGAAGCAGTTAATATATTCG
AAGGGAAATAACTATAGTGAGGTA -> AGGGAAATAACTATAGTGAGGTAC
GGGATCTGAGACGCAGCAATGTGG -> GGATCTGAGACGCAGCAATGTGGC
ATAACTTCACCCTAGGGTCGACCT -> TAACTTCACCCTAGGGTCGACCTC
GCCTAGACGTGGTAGATTCATGAC -> CCTAGACGTGGTAGATTCATGACC
GTTGTAAATCACTGCAGCGCTGCT -> TTGTAAATCACTGCAGCGCTGCTA
TAATCTATGAATGTCCATACATGC -> AATCTATGAATGTCCATACATGCA
CCGGGGAGATTGCCTCTTTGCCGG -> CGGGGAGATTGCCTCTTTGCCGGC
GAGCGACAGCGAAGCAGTTAATAT -> AGCGACAGCGAAGCAGTTAATATA
ATCTATGAATGTCCATACATGCAT -> TCTATGAATGTCCATACATGCATT
AATGTGGCTCTTCTATTTGAGGCA -> ATGTGGCTCTTCTATTTGAGGCAG
AGCCCGGGTTACCAAGTTGCTCAA -> GCCCGGGTTACCAAGTTGCTCAAC
GGTCCTGCTAGGGATCAGACGATG -> GTCCTGCTAGGGATCAGACGATGG
CTTTCGGTCTACATGTCCGGGGAG -> TTTCGGTCTACATGTCCGGGGAGA
CAGCGCTGCTACTCACCTTAATTA -> AGCGCTGCTACTCACCTTAATTAA
AGACGATGGGATCTCAAAGCAAAT -> GACGATGGGATCTCAAAGCAAATC
TACACCTTCTCTTGTTTGGCTCTA -> ACACCTTCTCTTGTTTGGCTCTAG
TTGTATGAGACCGTGCGATGCGCA -> TGTATGAGACCGTGCGATGCGCAT
TGCTTCCCTCCGTCCATAGTCTGA -> GCTTCCCTCCGTCCATAGTCTGAC
AAACCTCGCGTTGTCTGCTAGTGA -> AACCTCGCGTTGTCTGCTAGTGAG
TAGCACCTTGACGCGAGCTGTACT -> AGCACCTTGACGCGAGCTGTACTG
AAAGCAAATCCCTATAGCCCATCA -> AAGCAAATCCCTATAGCCCATCAG
CTATCAAATTCCGATCTCTCACTT -> TATCAAATTCCGATCTCTCACTTG
CCGGGTTACCAAGTTGCTCAACGC -> CGGGTTACCAAGTTGCTCAACGCG
TCTCGTGGCCTAGACGTGGTAGAT -> CTCGTGGCCTAGACGTGGTAGATT
CCTATTGGCGCCAAGAGCTTTCAT -> CTATTGGCGCCAAGAGCTTTCATC
TCTATGAATGTCCATACATGCATT -> CTATGAATGTCCATACATGCATTA
ACTGTCCAATGTCATCTCTGACCG -> CTGTCCAATGTCATCTCTGACCGG
GCCCGGGCCCGGCAAGGCCTCTTG -> CCCGGGCCCGGCAAGGCCTCTTGA
AACCCTGAATAACAGGGCACTGCG -> ACCCTGAATAACAGGGCACTGCGC
ACAGGGCACTGCGCAGAATCCTGA -> CAGGGCACTGCGCAGAATCCTGAC
AAGGGGAGCTCGCTAAGCCCTCCC -> AGGGGAGCTCGCTAAGCCCTCCCC
TCTTTTTGATAAGTCGTTGCACCA -> CTTTTTGATAAGTCGTTGCACCAG
AATCAATACGGGGGAATTCGTCAA -> ATCAATACGGGGGAATTCGTCAAA
GCTTGTTTCACTACCCTCTTAAGC -> CTTGTTTCACTACCCTCTTAAGCT
CAACGCGGTCTTTCTAAAATTCGT -> AACGCGGTCTTTCTAAAATTCGTC
CATCTCTGACCGGATAATAACTTC -> ATCTCTGACCGGATAATAACTTCA
ATGCGCATCGGAGTCAGCATCGAA -> TGCGCATCGGAGTCAGCATCGAAT
ACAATGAGCGCTGCTTCCCTCCGT -> CAATGAGCGCTGCTTCCCTCCGTC
GAAATTTGTTATCCGGATTGATCT -> AAATTTGTTATCCGGATTGATCTC
GTCCCTCGCACAGGTACTCTTAGC -> TCCCTCGCACAGGTACTCTTAGCA
GACGGCCCCCCAACTCCGGGTCCT -> ACGGCCCCCCAACTCCGGGTCCTG
TCTGAGTCAGCGTGTCTTTTTGAT -> CTGAGTCAGCGTGTCTTTTTGATA
GTTCATGCCCTGGTGGCAGCTTTG -> TTCATGCCCTGGTGGCAGCTTTGA
ACATGTCCGGGGAGATTGCCTCTT -> CATGTCCGGGGAGATTGCCTCTTT
CCTTGACGCGAGCTGTACTGTGCC -> CTTGACGCGAGCTGTACTGTGCCG
TGAGATGCCCGAGTGACGGGCTAG -> GAGATGCCCGAGTGACGGGCTAGT
GGAGGGGGCTCTTGGGAAGTTAGA -> GAGGGGGCTCTTGGGAAGTTAGAG
CGATAGGTCATCAAGAAAGGCCCA -> GATAGGTCATCAAGAAAGGCCCAG
TTGAGGCAGACTAAGCCCGGGTTA -> TGAGGCAGACTAAGCCCGGGTTAC
AGTCCCTCGCACAGGTACTCTTAG -> GTCCCTCGCACAGGTACTCTTAGC
AACGCGGTCTTTCTAAAATTCGTC -> ACGCGGTCTTTCTAAAATTCGTCT
AGGGGGCTCTTGGGAAGTTAGAGA -> GGGGGCTCTTGGGAAGTTAGAGAT
GTGGCCTAGACGTGGTAGATTCAT -> TGGCCTAGACGTGGTAGATTCATG
CCTGAGGTTGAAAAATTGCTCGAA -> CTGAGGTTGAAAAATTGCTCGAAA
CGATGCGCATCGGAGTCAGCATCG -> GATGCGCATCGGAGTCAGCATCGA
TGAGGTACGAAAGTGCTAGCGATA -> GAGGTACGAAAGTGCTAGCGATAG
TCACTTGATTAAATCCAGAACCCT -> CACTTGATTAAATCCAGAACCCTG
TTCCCTCCGTCCATAGTCTGACAG -> TCCCTCCGTCCATAGTCTGACAGG
TAGTGCTTTATCTGTTAGGTACAC -> AGTGCTTTATCTGTTAGGTACACC
ACTGCAGCGCTGCTACTCACCTTA -> CTGCAGCGCTGCTACTCACCTTAA
GAAAGGCCCAGTGCAAGGGCACAC -> AAAGGCCCAGTGCAAGGGCACACA
GCAGCAATGTGGCTCTTCTATTTG -> CAGCAATGTGGCTCTTCTATTTGA
CCCCCTGAGGTTGAAAAATTGCTC -> CCCCTGAGGTTGAAAAATTGCTCG
AAATTCGTCTTCGGGCCTTTCGGT -> AATTCGTCTTCGGGCCTTTCGGTC
CAGATTTGTGAGCACTAGTAGTCC -> AGATTTGTGAGCACTAGTAGTCCC
AGCTCGCTAAGCCCTCCCCCTGAG -> GCTCGCTAAGCCCTCCCCCTGAGG
GCTAGGGATCAGACGATGGGATCT -> CTAGGGATCAGACGATGGGATCTC
TGGCTCTCACTGTCCAATGTCATC -> GGCTCTCACTGTCCAATGTCATCT
TCCCTCGCACAGGTACTCTTAGCA -> CCCTCGCACAGGTACTCTTAGCAC
ACAGAGTAGCAACGTTTGGCTCTA -> CAGAGTAGCAACGTTTGGCTCTAT
GAAATAAACTGCGGTCAACCATCC -> AAATAAACTGCGGTCAACCATCCC
ATACGGGGGAATTCGTCAAAAGAA -> TACGGGGGAATTCGTCAAAAGAAA
ACTGTAACCAAAACCGATACTATC -> CTGTAACCAAAACCGATACTATCA
ACACCTTCTCTTGTTTGGCTCTAG -> CACCTTCTCTTGTTTGGCTCTAGA
CCGAACATTGCGACAGTGATAGTA -> CGAACATTGCGACAGTGATAGTAA
GATGCCCGAGTGACGGGCTAGTAA -> ATGCCCGAGTGACGGGCTAGTAAA
CGTGACTCCGAAATTTGTTATCCG -> GTGACTCCGAAATTTGTTATCCGG
ATAGTCGACGCTACTACGGTAGCT -> TAGTCGACGCTACTACGGTAGCTC
TTGCTCAACGCGGTCTTTCTAAAA -> TGCTCAACGCGGTCTTTCTAAAAT
TGCTACTCACCTTAATTAATGCAC -> GCTACTCACCTTAATTAATGCACA
CGCGAGCTGTACTGTGCCGCCGGC -> GCGAGCTGTACTGTGCCGCCGGCA
ATTGGCACCGAATACCGAACATTG -> TTGGCACCGAATACCGAACATTGC
GAACGAGACGAGGATAGTGCTTTA -> AACGAGACGAGGATAGTGCTTTAT
ATCGAATTAATTGTGCCGAGCGAC -> TCGAATTAATTGTGCCGAGCGACA
CAAGGGCACACACGTTTTACAGGT -> AAGGGCACACACGTTTTACAGGTC
GTTAGAGATGGCTCTCACTGTCCA -> TTAGAGATGGCTCTCACTGTCCAA
GTCCATAGTCTGACAGGTGGCTCA -> TCCATAGTCTGACAGGTGGCTCAG
GAACTATACGGGCCAACGCCGCGT -> AACTATACGGGCCAACGCCGCGTA
AATATAGTCGACGCTACTACGGTA -> ATATAGTCGACGCTACTACGGTAG
GATCTCGCCGGTTCGAGAAGGGAG -> ATCTCGCCGGTTCGAGAAGGGAGC
TTCACTACCCTCTTAAGCTACTAA -> TCACTACCCTCTTAAGCTACTAAA
CTGACAGGTGGCTCAGGTAACTTA -> TGACAGGTGGCTCAGGTAACTTAC
GTCAAAAGAAAAAGGGAAATAACT -> TCAAAAGAAAAAGGGAAATAACTA
TCGAGTGGAGGGGGCTCTTGGGAA -> CGAGTGGAGGGGGCTCTTGGGAAG
TTATAAATGAAAGGGATCTGAGAC -> TATAAATGAAAGGGATCTGAGACG
ACACGTTTTACAGGTCGATACGCG -> CACGTTTTACAGGTCGATACGCGG
ATAGAGTTAATCTATGAATGTCCA -> TAGAGTTAATCTATGAATGTCCAT
GGATCTGAGACGCAGCAATGTGGC -> GATCTGAGACGCAGCAATGTGGCT
ACTGTGCCGCCGGCATACGTCCTG -> CTGTGCCGCCGGCATACGTCCTGT
TGAGGCAGACTAAGCCCGGGTTAC -> GAGGCAGACTAAGCCCGGGTTACC
TACTGGTAACTGTTTGGCCTATTG -> ACTGGTAACTGTTTGGCCTATTGG
GTAACCAAAACCGATACTATCAAA -> TAACCAAAACCGATACTATCAAAT
TGCACAGTCTGAGAAAGTTTGGAG -> GCACAGTCTGAGAAAGTTTGGAGT
GCAGCTTTGAGCGCACAGAAATAT -> CAGCTTTGAGCGCACAGAAATATA
ATAAATGAAAGGGATCTGAGACGC -> TAAATGAAAGGGATCTGAGACGCA
ACGCGGTCTTTCTAAAATTCGTCT -> CGCGGTCTTTCTAAAATTCGTCTT
ACAGTGGCCTATAACGCACGGTCC -> CAGTGGCCTATAACGCACGGTCCT
TACCTATGCCGGTAATTTCTCGTG -> ACCTATGCCGGTAATTTCTCGTGG
CCAGACGTTCATGCCCTGGTGGCA -> CAGACGTTCATGCCCTGGTGGCAG
GAGGTACGAAAGTGCTAGCGATAG -> AGGTACGAAAGTGCTAGCGATAGG
GGCACTGCGCAGAATCCTGACGGC -> GCACTGCGCAGAATCCTGACGGCC
GAACCAGGTCAGCCGACAATGCCC -> AACCAGGTCAGCCGACAATGCCCC
ACGCAGCAATGTGGCTCTTCTATT -> CGCAGCAATGTGGCTCTTCTATTT
AATAACTTCACCCTAGGGTCGACC -> ATAACTTCACCCTAGGGTCGACCT
AAAGAACCAGGTCAGCCGACAATG -> AAGAACCAGGTCAGCCGACAATGC
TTAATCCCACCATCGTTATAAATG -> TAATCCCACCATCGTTATAAATGA
CGTTTTACAGGTCGATACGCGGCT -> GTTTTACAGGTCGATACGCGGCTT
CCGGCGCCGCCCGGGCCCGGCAAG -> CGGCGCCGCCCGGGCCCGGCAAGG
GGCCTTTCGGTCTACATGTCCGGG -> GCCTTTCGGTCTACATGTCCGGGG
CTAAGCCCTCCCCCTGAGGTTGAA -> TAAGCCCTCCCCCTGAGGTTGAAA
AGTGATAGTAAACCTCGCGTTGTC -> GTGATAGTAAACCTCGCGTTGTCT
ACCTTGACGCGAGCTGTACTGTGC -> CCTTGACGCGAGCTGTACTGTGCC
AACTCCGGGTCCTGCTAGGGATCA -> ACTCCGGGTCCTGCTAGGGATCAG
TGAGACGCAGCAATGTGGCTCTTC -> GAGACGCAGCAATGTGGCTCTTCT
ATGCCGGTAATTTCTCGTGGCCTA -> TGCCGGTAATTTCTCGTGGCCTAG
AGACCGTGCGATGCGCATCGGAGT -> GACCGTGCGATGCGCATCGGAGTC
CGCTATATTTTGCAAACACAATGA -> GCTATATTTTGCAAACACAATGAG
AGAGATGGCTCTCACTGTCCAATG -> GAGATGGCTCTCACTGTCCAATGT
CCCGGGTTACCAAGTTGCTCAACG -> CCGGGTTACCAAGTTGCTCAACGC
CCCCCAACTCCGGGTCCTGCTAGG -> CCCCAACTCCGGGTCCTGCTAGGG
AATAATCAATACGGGGGAATTCGT -> ATAATCAATACGGGGGAATTCGTC
ACAGGTGGCTCAGGTAACTTACGA -> CAGGTGGCTCAGGTAACTTACGAG
CCGGACAACTGTAACCAAAACCGA -> CGGACAACTGTAACCAAAACCGAT
CTTAATTAATGCACAGTCTGAGAA -> TTAATTAATGCACAGTCTGAGAAA
GAATCCTGACGGCCCCCCAACTCC -> AATCCTGACGGCCCCCCAACTCCG
CATCCCCCTATCCGGACAACTGTA -> ATCCCCCTATCCGGACAACTGTAA
GCGGCTTTTGGATATACAGATTTG -> CGGCTTTTGGATATACAGATTTGT
TTTCATCTGAGTCAGCGTGTCTTT -> TTCATCTGAGTCAGCGTGTCTTTT
GTGCAAGGGCACACACGTTTTACA -> TGCAAGGGCACACACGTTTTACAG
ATGAGGAATAGGCGCTGAGATGCC -> TGAGGAATAGGCGCTGAGATGCCC
TGACAGGTGGCTCAGGTAACTTAC -> GACAGGTGGCTCAGGTAACTTACG
ACAGGTCGATACGCGGCTTTTGGA -> CAGGTCGATACGCGGCTTTTGGAT
GCGCCGCCCGGGCCCGGCAAGGCC -> CGCCGCCCGGGCCCGGCAAGGCCT
AGGCCCAGTGCAAGGGCACACACG -> GGCCCAGTGCAAGGGCACACACGT
AAATAAACTGCGGTCAACCATCCC -> AATAAACTGCGGTCAACCATCCCC
TAGTGAGGTACGAAAGTGCTAGCG -> AGTGAGGTACGAAAGTGCTAGCGA
GGGAGCATTTTCAGATTGCTTGTT -> GGAGCATTTTCAGATTGCTTGTTT
AAAAAGGGAAATAACTATAGTGAG -> AAAAGGGAAATAACTATAGTGAGG
AGCGCTGCTACTCACCTTAATTAA -> GCGCTGCTACTCACCTTAATTAAT
CAGCTTTGAGCGCACAGAAATATA -> AGCTTTGAGCGCACAGAAATATAG
GTCTGTTAAGGGGAGCTCGCTAAG -> TCTGTTAAGGGGAGCTCGCTAAGC
TTCGGGCCTTTCGGTCTACATGTC -> TCGGGCCTTTCGGTCTACATGTCC
TCGAAACTAAGTACTGGTAACTGT -> CGAAACTAAGTACTGGTAACTGTT
TATAGCCCATCAGAACGAGACGAG -> ATAGCCCATCAGAACGAGACGAGG
CCTTAATTAATGCACAGTCTGAGA -> CTTAATTAATGCACAGTCTGAGAA
TTTGGCTCTATTGTCTGTTAAGGG -> TTGGCTCTATTGTCTGTTAAGGGG
CGTGTCTTTTTGATAAGTCGTTGC -> GTGTCTTTTTGATAAGTCGTTGCA
GGGCTCTTGGGAAGTTAGAGATGG -> GGCTCTTGGGAAGTTAGAGATGGC
AGCCCTCCCCCTGAGGTTGAAAAA -> GCCCTCCCCCTGAGGTTGAAAAAT
TGTTAAGGGGAGCTCGCTAAGCCC -> GTTAAGGGGAGCTCGCTAAGCCCT
TTGTTTCACTACCCTCTTAAGCTA -> TGTTTCACTACCCTCTTAAGCTAC
TCATCAAGAAAGGCCCAGTGCAAG -> CATCAAGAAAGGCCCAGTGCAAGG
GTACGAAAGTGCTAGCGATAGGTC -> TACGAAAGTGCTAGCGATAGGTCA
CAAACACAATGAGCGCTGCTTCCC -> AAACACAATGAGCGCTGCTTCCCT
GACAGTGGCCTATAACGCACGGTC -> ACAGTGGCCTATAACGCACGGTCC
ATCCGGATTGATCTCGCCGGTTCG -> TCCGGATTGATCTCGCCGGTTCGA
CCAATGTCATCTCTGACCGGATAA -> CAATGTCATCTCTGACCGGATAAT
CGGATTGATCTCGCCGGTTCGAGA -> GGATTGATCTCGCCGGTTCGAGAA
TGTGAGACAGTGGCCTATAACGCA -> GTGAGACAGTGGCCTATAACGCAC
AAATATAGTCGACGCTACTACGGT -> AATATAGTCGACGCTACTACGGTA
GTGGAGGGGGCTCTTGGGAAGTTA -> TGGAGGGGGCTCTTGGGAAGTTAG
ACCGAATACCGAACATTGCGACAG -> CCGAATACCGAACATTGCGACAGT
GCATACGTCCTGTGAGACAGTGGC -> CATACGTCCTGTGAGACAGTGGCC
AGCTCACCATTGAAGTAGAATAAT -> GCTCACCATTGAAGTAGAATAATC
CCGATACTATCAAATTCCGATCTC -> CGATACTATCAAATTCCGATCTCT
ATAGGAATAGAGTTAATCTATGAA -> TAGGAATAGAGTTAATCTATGAAT
ATTTTGCAAACACAATGAGCGCTG -> TTTTGCAAACACAATGAGCGCTGC
CCTCCCCCTGAGGTTGAAAAATTG -> CTCCCCCTGAGGTTGAAAAATTGC
TGCGACAGTGATAGTAAACCTCGC -> GCGACAGTGATAGTAAACCTCGCG
CGACAGCGAAGCAGTTAATATATT -> GACAGCGAAGCAGTTAATATATTC
CACAGAAATATAGTCGACGCTACT -> ACAGAAATATAGTCGACGCTACTA
TTAAAGGGTTCACGCCGTGGACAC -> TAAAGGGTTCACGCCGTGGACACT
AACGTTGTCTATTGGCACCGAATA -> ACGTTGTCTATTGGCACCGAATAC
GCTCTATTGTCTGTTAAGGGGAGC -> CTCTATTGTCTGTTAAGGGGAGCT
GATTGATCTCGCCGGTTCGAGAAG -> ATTGATCTCGCCGGTTCGAGAAGG
GGAATAGAGTTAATCTATGAATGT -> GAATAGAGTTAATCTATGAATGTC
CTCGCACAGGTACTCTTAGCACCT -> TCGCACAGGTACTCTTAGCACCTT
AAAGTCTTAGACAGAGTAGCAACG -> AAGTCTTAGACAGAGTAGCAACGT
AATCCAGAACCCTGAATAACAGGG -> ATCCAGAACCCTGAATAACAGGGC
CACATTGCCGGAACTATAGGAATA -> ACATTGCCGGAACTATAGGAATAG
TGTAAATCACTGCAGCGCTGCTAC -> GTAAATCACTGCAGCGCTGCTACT
ACTGTTTGGCCTATTGGCGCCAAG -> CTGTTTGGCCTATTGGCGCCAAGA
CCGCCGGCATACGTCCTGTGAGAC -> CGCCGGCATACGTCCTGTGAGACA
ACGTTTGGCTCTATTGTCTGTTAA -> CGTTTGGCTCTATTGTCTGTTAAG
CAGACGTTCATGCCCTGGTGGCAG -> AGACGTTCATGCCCTGGTGGCAGC
GGATAGTGCTTTATCTGTTAGGTA -> GATAGTGCTTTATCTGTTAGGTAC
GTCAGCCGACAATGCCCCATGCCC -> TCAGCCGACAATGCCCCATGCCCT
GTCTGCTAGTGAGCTCTTACGCTT -> TCTGCTAGTGAGCTCTTACGCTTA
TACGAGGAACTATACGGGCCAACG -> ACGAGGAACTATACGGGCCAACGC
TATCTGTTAGGTACACCTTCTCTT -> ATCTGTTAGGTACACCTTCTCTTG
ATATTTTGCAAACACAATGAGCGC -> TATTTTGCAAACACAATGAGCGCT
GTCCTGCTAGGGATCAGACGATGG -> TCCTGCTAGGGATCAGACGATGGG
TTCGTCTTCGGGCCTTTCGGTCTA -> TCGTCTTCGGGCCTTTCGGTCTAC
TCAGATTGCTTGTTTCACTACCCT -> CAGATTGCTTGTTTCACTACCCTC
ACATTGCGACAGTGATAGTAAACC -> CATTGCGACAGTGATAGTAAACCT
GGGCGTGGGAACGTTGTCTATTGG -> GGCGTGGGAACGTTGTCTATTGGC
AACTGTAACCAAAACCGATACTAT -> ACTGTAACCAAAACCGATACTATC
TTCGTTGTATGAGACCGTGCGATG -> TCGTTGTATGAGACCGTGCGATGC
CGTCCATAGTCTGACAGGTGGCTC -> GTCCATAGTCTGACAGGTGGCTCA
TCCGGATTGATCTCGCCGGTTCGA -> CCGGATTGATCTCGCCGGTTCGAG
GTAAACTGCGAAATAAACTGCGGT -> TAAACTGCGAAATAAACTGCGGTC
ACTCAATGAGGAATAGGCGCTGAG -> CTCAATGAGGAATAGGCGCTGAGA
CGGTTCGAGAAGGGAGCATTTTCA -> GGTTCGAGAAGGGAGCATTTTCAG
TATTCGGGCGTGGGAACGTTGTCT -> ATTCGGGCGTGGGAACGTTGTCTA
AAACCGATACTATCAAATTCCGAT -> AACCGATACTATCAAATTCCGATC
CAACGTTTGGCTCTATTGTCTGTT -> AACGTTTGGCTCTATTGTCTGTTA
ATAACAGGGCACTGCGCAGAATCC -> TAACAGGGCACTGCGCAGAATCCT
TTTATCTGTTAGGTACACCTTCTC -> TTATCTGTTAGGTACACCTTCTCT
TGTGCCGAGCGACAGCGAAGCAGT -> GTGCCGAGCGACAGCGAAGCAGTT
GACAATGCCCCATGCCCTCGAGTG -> ACAATGCCCCATGCCCTCGAGTGG
GTTGTCTATTGGCACCGAATACCG -> TTGTCTATTGGCACCGAATACCGA
AAAGTGCTAGCGATAGGTCATCAA -> AAGTGCTAGCGATAGGTCATCAAG
CTACGGTAGCTCACCATTGAAGTA -> TACGGTAGCTCACCATTGAAGTAG
AATGTCATCTCTGACCGGATAATA -> ATGTCATCTCTGACCGGATAATAA
CACCCTAGGGTCGACCTCTGGGCG -> ACCCTAGGGTCGACCTCTGGGCGC
AAATAACTATAGTGAGGTACGAAA -> AATAACTATAGTGAGGTACGAAAG
GGACAACTGTAACCAAAACCGATA -> GACAACTGTAACCAAAACCGATAC
ATCCCACCATCGTTATAAATGAAA -> TCCCACCATCGTTATAAATGAAAG
CGCCGGCATACGTCCTGTGAGACA -> GCCGGCATACGTCCTGTGAGACAG
TCTGTTAAGGGGAGCTCGCTAAGC -> CTGTTAAGGGGAGCTCGCTAAGCC
AAGGGATCTGAGACGCAGCAATGT -> AGGGATCTGAGACGCAGCAATGTG
AAGAACCAGGTCAGCCGACAATGC -> AGAACCAGGTCAGCCGACAATGCC
TAGCTCACCATTGAAGTAGAATAA -> AGCTCACCATTGAAGTAGAATAAT
TATATTTTGCAAACACAATGAGCG -> ATATTTTGCAAACACAATGAGCGC
AACTAACTCAATGAGGAATAGGCG -> ACTAACTCAATGAGGAATAGGCGC
TCATCTGAGTCAGCGTGTCTTTTT -> CATCTGAGTCAGCGTGTCTTTTTG
GTCGACGCTACTACGGTAGCTCAC -> TCGACGCTACTACGGTAGCTCACC
TGGCCTATAACGCACGGTCCTCCT -> GGCCTATAACGCACGGTCCTCCTA
GCCCATCAGAACGAGACGAGGATA -> CCCATCAGAACGAGACGAGGATAG
CGCGTAATCATAGGACGTTGTAAA -> GCGTAATCATAGGACGTTGTAAAT
TTCATCTGAGTCAGCGTGTCTTTT -> TCATCTGAGTCAGCGTGTCTTTTT
ACAACTGTAACCAAAACCGATACT -> CAACTGTAACCAAAACCGATACTA
TCCGGGGAGATTGCCTCTTTGCCG -> CCGGGGAGATTGCCTCTTTGCCGG
TTTTCAGATTGCTTGTTTCACTAC -> TTTCAGATTGCTTGTTTCACTACC
GGGCACTGCGCAGAATCCTGACGG -> GGCACTGCGCAGAATCCTGACGGC
TTAATTGTGCCGAGCGACAGCGAA -> TAATTGTGCCGAGCGACAGCGAAG
GTAAATCACTGCAGCGCTGCTACT -> TAAATCACTGCAGCGCTGCTACTC
ATGTCCGGGGAGATTGCCTCTTTG -> TGTCCGGGGAGATTGCCTCTTTGC
GAATAACAGGGCACTGCGCAGAAT -> AATAACAGGGCACTGCGCAGAATC
ACGTATGACACTCACATTGCCGGA -> CGTATGACACTCACATTGCCGGAA
TGTTTGCTTCTCAGGTACGCTATA -> GTTTGCTTCTCAGGTACGCTATAT
CGGTAGCTCACCATTGAAGTAGAA -> GGTAGCTCACCATTGAAGTAGAAT
CCCTCGCACAGGTACTCTTAGCAC -> CCTCGCACAGGTACTCTTAGCACC
TGAAAAATTGCTCGAAACTAAGTA -> GAAAAATTGCTCGAAACTAAGTAC
GGAACTATACGGGCCAACGCCGCG -> GAACTATACGGGCCAACGCCGCGT
TGTAACCAAAACCGATACTATCAA -> GTAACCAAAACCGATACTATCAAA
AACCAGGTCAGCCGACAATGCCCC -> ACCAGGTCAGCCGACAATGCCCCA
TAATTAATGCACAGTCTGAGAAAG -> AATTAATGCACAGTCTGAGAAAGT
AACTATAGGAATAGAGTTAATCTA -> ACTATAGGAATAGAGTTAATCTAT
TTACGTATGACACTCACATTGCCG -> TACGTATGACACTCACATTGCCGG
TCATGACCATTTCGTTGTATGAGA -> CATGACCATTTCGTTGTATGAGAC
ATTCGTCTTCGGGCCTTTCGGTCT -> TTCGTCTTCGGGCCTTTCGGTCTA
CTGAGTCAGCGTGTCTTTTTGATA -> TGAGTCAGCGTGTCTTTTTGATAA
CTGAGACGCAGCAATGTGGCTCTT -> TGAGACGCAGCAATGTGGCTCTTC
CTGCTTCCCTCCGTCCATAGTCTG -> TGCTTCCCTCCGTCCATAGTCTGA
GGCAGACTAAGCCCGGGTTACCAA -> GCAGACTAAGCCCGGGTTACCAAG
GGGAAATAACTATAGTGAGGTACG -> GGAAATAACTATAGTGAGGTACGA
TGGCAGCTTTGAGCGCACAGAAAT -> GGCAGCTTTGAGCGCACAGAAATA
TGCTACTGCCATGTTTGCTTCTCA -> GCTACTGCCATGTTTGCTTCTCAG
TATACGGGCCAACGCCGCGTAATC -> ATACGGGCCAACGCCGCGTAATCA
AAAGGGTTCACGCCGTGGACACTT -> AAGGGTTCACGCCGTGGACACTTG
CTTAATCCCACCATCGTTATAAAT -> TTAATCCCACCATCGTTATAAATG
TCTGAGACGCAGCAATGTGGCTCT -> CTGAGACGCAGCAATGTGGCTCTT
GACGAGGATAGTGCTTTATCTGTT -> ACGAGGATAGTGCTTTATCTGTTA
TACTACGGTAGCTCACCATTGAAG -> ACTACGGTAGCTCACCATTGAAGT
AGATTGCTTGTTTCACTACCCTCT -> GATTGCTTGTTTCACTACCCTCTT
CATAGTCTGACAGGTGGCTCAGGT -> ATAGTCTGACAGGTGGCTCAGGTA
TAGTAAACCTCGCGTTGTCTGCTA -> AGTAAACCTCGCGTTGTCTGCTAG
GACGTTCATGCCCTGGTGGCAGCT -> ACGTTCATGCCCTGGTGGCAGCTT
ATTTGTGAGCACTAGTAGTCCCTC -> TTTGTGAGCACTAGTAGTCCCTCG
CTGACGGCCCCCCAACTCCGGGTC -> TGACGGCCCCCCAACTCCGGGTCC
TCAATACGGGGGAATTCGTCAAAA -> CAATACGGGGGAATTCGTCAAAAG
GATACGTGACTCCGAAATTTGTTA -> ATACGTGACTCCGAAATTTGTTAT
TGTGCCGCCGGCATACGTCCTGTG -> GTGCCGCCGGCATACGTCCTGTGA
CTATCCGGACAACTGTAACCAAAA -> TATCCGGACAACTGTAACCAAAAC
CAACTGTAACCAAAACCGATACTA -> AACTGTAACCAAAACCGATACTAT
CATACGTCCTGTGAGACAGTGGCC -> ATACGTCCTGTGAGACAGTGGCCT
TGCTTCTCAGGTACGCTATATTTT -> GCTTCTCAGGTACGCTATATTTTG
GCACAGAAATATAGTCGACGCTAC -> CACAGAAATATAGTCGACGCTACT
GACCTCTGGGCGCCCCTCCCAAAA -> ACCTCTGGGCGCCCCTCCCAAAAG
GCGTGTCTTTTTGATAAGTCGTTG -> CGTGTCTTTTTGATAAGTCGTTGC
TGTTATCCGGATTGATCTCGCCGG -> GTTATCCGGATTGATCTCGCCGGT
ACCATTGAAGTAGAATAATCAATA -> CCATTGAAGTAGAATAATCAATAC
TTGCCTCTTTGCCGGCGCCGCCCG -> TGCCTCTTTGCCGGCGCCGCCCGG
ACCCTGAATAACAGGGCACTGCGC -> CCCTGAATAACAGGGCACTGCGCA
AGCAGTTAATATATTCGGGCGTGG -> GCAGTTAATATATTCGGGCGTGGG
AAGTAGAATAATCAATACGGGGGA -> AGTAGAATAATCAATACGGGGGAA
ACGCCGCGTAATCATAGGACGTTG -> CGCCGCGTAATCATAGGACGTTGT
TCACTACCCTCTTAAGCTACTAAA -> CACTACCCTCTTAAGCTACTAAAG
GTTATAAATGAAAGGGATCTGAGA -> TTATAAATGAAAGGGATCTGAGAC
TCTCACTGTCCAATGTCATCTCTG -> CTCACTGTCCAATGTCATCTCTGA
CGCCGGTTCGAGAAGGGAGCATTT -> GCCGGTTCGAGAAGGGAGCATTTT
CGCAGCAATGTGGCTCTTCTATTT -> GCAGCAATGTGGCTCTTCTATTTG
GCGCACAGAAATATAGTCGACGCT -> CGCACAGAAATATAGTCGACGCTA
CACAGTCTGAGAAAGTTTGGAGTC -> ACAGTCTGAGAAAGTTTGGAGTCA
CTGAGATGCCCGAGTGACGGGCTA -> TGAGATGCCCGAGTGACGGGCTAG
ATAATCAATACGGGGGAATTCGTC -> TAATCAATACGGGGGAATTCGTCA
TGGACACTTGCTACTGCCATGTTT -> GGACACTTGCTACTGCCATGTTTG
ATTAAAGGGTTCACGCCGTGGACA -> TTAAAGGGTTCACGCCGTGGACAC
CGGGTCCTGCTAGGGATCAGACGA -> GGGTCCTGCTAGGGATCAGACGAT
CCCCTCCCAAAAGTCTTAGACAGA -> CCCTCCCAAAAGTCTTAGACAGAG
AGTCGTTGCACCAGACGTTCATGC -> GTCGTTGCACCAGACGTTCATGCC
GTGTCTTTTTGATAAGTCGTTGCA -> TGTCTTTTTGATAAGTCGTTGCAC
CCCTCGAGTGGAGGGGGCTCTTGG -> CCTCGAGTGGAGGGGGCTCTTGGG
CACGCCGTGGACACTTGCTACTGC -> ACGCCGTGGACACTTGCTACTGCC
GGCCTATAACGCACGGTCCTCCTA -> GCCTATAACGCACGGTCCTCCTAC
AACTATAGTGAGGTACGAAAGTGC -> ACTATAGTGAGGTACGAAAGTGCT
GCGTGGGAACGTTGTCTATTGGCA -> CGTGGGAACGTTGTCTATTGGCAC
GACTCCGAAATTTGTTATCCGGAT -> ACTCCGAAATTTGTTATCCGGATT
TACTGCCATGTTTGCTTCTCAGGT -> ACTGCCATGTTTGCTTCTCAGGTA
AGATTTGTGAGCACTAGTAGTCCC -> GATTTGTGAGCACTAGTAGTCCCT
TCGTTATAAATGAAAGGGATCTGA -> CGTTATAAATGAAAGGGATCTGAG
CAGACGATGGGATCTCAAAGCAAA -> AGACGATGGGATCTCAAAGCAAAT
AAGCAGTTAATATATTCGGGCGTG -> AGCAGTTAATATATTCGGGCGTGG
GTTTGGCTCTATTGTCTGTTAAGG -> TTTGGCTCTATTGTCTGTTAAGGG
TAATCATAGGACGTTGTAAATCAC -> AATCATAGGACGTTGTAAATCACT
TAAATCCAGAACCCTGAATAACAG -> AAATCCAGAACCCTGAATAACAGG
TTTGCTTCTCAGGTACGCTATATT -> TTGCTTCTCAGGTACGCTATATTT
AGATTCATGACCATTTCGTTGTAT -> GATTCATGACCATTTCGTTGTATG
CAAGAGCTTTCATCTGAGTCAGCG -> AAGAGCTTTCATCTGAGTCAGCGT
GCCGCGTAATCATAGGACGTTGTA -> CCGCGTAATCATAGGACGTTGTAA
AGGATAGTGCTTTATCTGTTAGGT -> GGATAGTGCTTTATCTGTTAGGTA
TAGTCGACGCTACTACGGTAGCTC -> AGTCGACGCTACTACGGTAGCTCA
CCATCGTTATAAATGAAAGGGATC -> CATCGTTATAAATGAAAGGGATCT
CTCGCCGGTTCGAGAAGGGAGCAT -> TCGCCGGTTCGAGAAGGGAGCATT
GGGGGAATTCGTCAAAAGAAAAAG -> GGGGAATTCGTCAAAAGAAAAAGG
TTGTCTGTTAAGGGGAGCTCGCTA -> TGTCTGTTAAGGGGAGCTCGCTAA
TCTCTCACTTGATTAAATCCAGAA -> CTCTCACTTGATTAAATCCAGAAC
TAGACAGAGTAGCAACGTTTGGCT -> AGACAGAGTAGCAACGTTTGGCTC
GTGAGGTACGAAAGTGCTAGCGAT -> TGAGGTACGAAAGTGCTAGCGATA
CCTCTTTGCCGGCGCCGCCCGGGC -> CTCTTTGCCGGCGCCGCCCGGGCC
CCTCGCACAGGTACTCTTAGCACC -> CTCGCACAGGTACTCTTAGCACCT
CCATGCCCTCGAGTGGAGGGGGCT -> CATGCCCTCGAGTGGAGGGGGCTC
GCATCGGAGTCAGCATCGAATTAA -> CATCGGAGTCAGCATCGAATTAAT
GATTCATGACCATTTCGTTGTATG -> ATTCATGACCATTTCGTTGTATGA
TTAAGGGGAGCTCGCTAAGCCCTC -> TAAGGGGAGCTCGCTAAGCCCTCC
TCTCGCCGGTTCGAGAAGGGAGCA -> CTCGCCGGTTCGAGAAGGGAGCAT
CCTTTCGGTCTACATGTCCGGGGA -> CTTTCGGTCTACATGTCCGGGGAG
CGAAACTAAGTACTGGTAACTGTT -> GAAACTAAGTACTGGTAACTGTTT
AATTAATGCACAGTCTGAGAAAGT -> ATTAATGCACAGTCTGAGAAAGTT
GACAGGTGGCTCAGGTAACTTACG -> ACAGGTGGCTCAGGTAACTTACGA
CTCTATTGTCTGTTAAGGGGAGCT -> TCTATTGTCTGTTAAGGGGAGCTC
CATAGGACGTTGTAAATCACTGCA -> ATAGGACGTTGTAAATCACTGCAG
GGAGTCAGCATCGAATTAATTGTG -> GAGTCAGCATCGAATTAATTGTGC
GCGTAATCATAGGACGTTGTAAAT -> CGTAATCATAGGACGTTGTAAATC
AGACAGTGGCCTATAACGCACGGT -> GACAGTGGCCTATAACGCACGGTC
CCTAGGGTCGACCTCTGGGCGCCC -> CTAGGGTCGACCTCTGGGCGCCCC
CCATACATGCATTAAACTAACTCA -> CATACATGCATTAAACTAACTCAA
TGTCTGCTAGTGAGCTCTTACGCT -> GTCTGCTAGTGAGCTCTTACGCTT
AGCAACGTTTGGCTCTATTGTCTG -> GCAACGTTTGGCTCTATTGTCTGT
GAAAAAGGGAAATAACTATAGTGA -> AAAAAGGGAAATAACTATAGTGAG
CTGGTGGCAGCTTTGAGCGCACAG -> TGGTGGCAGCTTTGAGCGCACAGA
TTTACAGGTCGATACGCGGCTTTT -> TTACAGGTCGATACGCGGCTTTTG
AGGGATCTGAGACGCAGCAATGTG -> GGGATCTGAGACGCAGCAATGTGG
TCTATTTGAGGCAGACTAAGCCCG -> CTATTTGAGGCAGACTAAGCCCGG
GTCATCTCTGACCGGATAATAACT -> TCATCTCTGACCGGATAATAACTT
CTTTTTGATAAGTCGTTGCACCAG -> TTTTTGATAAGTCGTTGCACCAGA
AGAGAATTACGTATGACACTCACA -> GAGAATTACGTATGACACTCACAT
TAACAGGGCACTGCGCAGAATCCT -> AACAGGGCACTGCGCAGAATCCTG
TTTCACTACCCTCTTAAGCTACTA -> TTCACTACCCTCTTAAGCTACTAA
GGGCCAACGCCGCGTAATCATAGG -> GGCCAACGCCGCGTAATCATAGGA
ATCCCTATAGCCCATCAGAACGAG -> TCCCTATAGCCCATCAGAACGAGA
ACATGCATTAAACTAACTCAATGA -> CATGCATTAAACTAACTCAATGAG
GAGAAGGGAGCATTTTCAGATTGC -> AGAAGGGAGCATTTTCAGATTGCT
GACACTTGCTACTGCCATGTTTGC -> ACACTTGCTACTGCCATGTTTGCT
CCAAGTTGCTCAACGCGGTCTTTC -> CAAGTTGCTCAACGCGGTCTTTCT
AGTTGCTCAACGCGGTCTTTCTAA -> GTTGCTCAACGCGGTCTTTCTAAA
GCACTGCGCAGAATCCTGACGGCC -> CACTGCGCAGAATCCTGACGGCCC
AATAACTATAGTGAGGTACGAAAG -> ATAACTATAGTGAGGTACGAAAGT
TGCCGGAACTATAGGAATAGAGTT -> GCCGGAACTATAGGAATAGAGTTA
ATTTTCAGATTGCTTGTTTCACTA -> TTTTCAGATTGCTTGTTTCACTAC
GCAGAATCCTGACGGCCCCCCAAC -> CAGAATCCTGACGGCCCCCCAACT
GGTAATTTCTCGTGGCCTAGACGT -> GTAATTTCTCGTGGCCTAGACGTG
TTGGAGTCAGAGAATTACGTATGA -> TGGAGTCAGAGAATTACGTATGAC
CCGGTTCGAGAAGGGAGCATTTTC -> CGGTTCGAGAAGGGAGCATTTTCA
AATCTATGAATGTCCATACATGCA -> ATCTATGAATGTCCATACATGCAT
ATTGCTCGAAACTAAGTACTGGTA -> TTGCTCGAAACTAAGTACTGGTAA
GAAACTAAGTACTGGTAACTGTTT -> AAACTAAGTACTGGTAACTGTTTG
GTCTTAGACAGAGTAGCAACGTTT -> TCTTAGACAGAGTAGCAACGTTTG
TGCCCGAGTGACGGGCTAGTAAAC -> GCCCGAGTGACGGGCTAGTAAACT
ATTGAAGTAGAATAATCAATACGG -> TTGAAGTAGAATAATCAATACGGG
CTAACTCAATGAGGAATAGGCGCT -> TAACTCAATGAGGAATAGGCGCTG
TACGCTTAATCCCACCATCGTTAT -> ACGCTTAATCCCACCATCGTTATA
GGAAGTTAGAGATGGCTCTCACTG -> GAAGTTAGAGATGGCTCTCACTGT
TTAGGTACACCTTCTCTTGTTTGG -> TAGGTACACCTTCTCTTGTTTGGC
GGTTGAAAAATTGCTCGAAACTAA -> GTTGAAAAATTGCTCGAAACTAAG
GAGTGACGGGCTAGTAAACTGCGA -> AGTGACGGGCTAGTAAACTGCGAA
GTCCTCCTACCTATGCCGGTAATT -> TCCTCCTACCTATGCCGGTAATTT
GCTTTGAGCGCACAGAAATATAGT -> CTTTGAGCGCACAGAAATATAGTC
CGTTTGGCTCTATTGTCTGTTAAG -> GTTTGGCTCTATTGTCTGTTAAGG
AGGCAGACTAAGCCCGGGTTACCA -> GGCAGACTAAGCCCGGGTTACCAA
TCGACCTCTGGGCGCCCCTCCCAA -> CGACCTCTGGGCGCCCCTCCCAAA
CAACTCCGGGTCCTGCTAGGGATC -> AACTCCGGGTCCTGCTAGGGATCA
AGAGTTAATCTATGAATGTCCATA -> GAGTTAATCTATGAATGTCCATAC
ATACGTCCTGTGAGACAGTGGCCT -> TACGTCCTGTGAGACAGTGGCCTA
GGGTCCTGCTAGGGATCAGACGAT -> GGTCCTGCTAGGGATCAGACGATG
CGAGGAACTATACGGGCCAACGCC -> GAGGAACTATACGGGCCAACGCCG
GTTAGGTACACCTTCTCTTGTTTG -> TTAGGTACACCTTCTCTTGTTTGG
AGCAAATCCCTATAGCCCATCAGA -> GCAAATCCCTATAGCCCATCAGAA
CGGTCAACCATCCCCCTATCCGGA -> GGTCAACCATCCCCCTATCCGGAC
CGAAAGTGCTAGCGATAGGTCATC -> GAAAGTGCTAGCGATAGGTCATCA
ACTAGTAGTCCCTCGCACAGGTAC -> CTAGTAGTCCCTCGCACAGGTACT
GCTACTCACCTTAATTAATGCACA -> CTACTCACCTTAATTAATGCACAG
ATGGGATCTCAAAGCAAATCCCTA -> TGGGATCTCAAAGCAAATCCCTAT
GTGACGGGCTAGTAAACTGCGAAA -> TGACGGGCTAGTAAACTGCGAAAT
TATAGTCGACGCTACTACGGTAGC -> ATAGTCGACGCTACTACGGTAGCT
TTGTGCCGAGCGACAGCGAAGCAG -> TGTGCCGAGCGACAGCGAAGCAGT
GCAAACACAATGAGCGCTGCTTCC -> CAAACACAATGAGCGCTGCTTCCC
CCCTGGTGGCAGCTTTGAGCGCAC -> CCTGGTGGCAGCTTTGAGCGCACA
CTCCCAAAAGTCTTAGACAGAGTA -> TCCCAAAAGTCTTAGACAGAGTAG
ATTGATCTCGCCGGTTCGAGAAGG -> TTGATCTCGCCGGTTCGAGAAGGG
CGTGGACACTTGCTACTGCCATGT -> GTGGACACTTGCTACTGCCATGTT
ATTGTGCCGAGCGACAGCGAAGCA -> TTGTGCCGAGCGACAGCGAAGCAG
ATGAGCGCTGCTTCCCTCCGTCCA -> TGAGCGCTGCTTCCCTCCGTCCAT
GCGATAGGTCATCAAGAAAGGCCC -> CGATAGGTCATCAAGAAAGGCCCA
CGCCAAGAGCTTTCATCTGAGTCA -> GCCAAGAGCTTTCATCTGAGTCAG
AATCCCTATAGCCCATCAGAACGA -> ATCCCTATAGCCCATCAGAACGAG
CACCTTGACGCGAGCTGTACTGTG -> ACCTTGACGCGAGCTGTACTGTGC
GAGTTAATCTATGAATGTCCATAC -> AGTTAATCTATGAATGTCCATACA
CTAGGGTCGACCTCTGGGCGCCCC -> TAGGGTCGACCTCTGGGCGCCCCT
ACTGCGGTCAACCATCCCCCTATC -> CTGCGGTCAACCATCCCCCTATCC
TAAAGAACCAGGTCAGCCGACAAT -> AAAGAACCAGGTCAGCCGACAATG
TAGGGATCAGACGATGGGATCTCA -> AGGGATCAGACGATGGGATCTCAA
ATCAGAACGAGACGAGGATAGTGC -> TCAGAACGAGACGAGGATAGTGCT
CGTGGTAGATTCATGACCATTTCG -> GTGGTAGATTCATGACCATTTCGT
TTTTGGATATACAGATTTGTGAGC -> TTTGGATATACAGATTTGTGAGCA
TAGAATAATCAATACGGGGGAATT -> AGAATAATCAATACGGGGGAATTC
TACTCACCTTAATTAATGCACAGT -> ACTCACCTTAATTAATGCACAGTC
CAACCATCCCCCTATCCGGACAAC -> AACCATCCCCCTATCCGGACAACT
CGGCTTTTGGATATACAGATTTGT -> GGCTTTTGGATATACAGATTTGTG
TTCTATTTGAGGCAGACTAAGCCC -> TCTATTTGAGGCAGACTAAGCCCG
TCAGGTAACTTACGAGGAACTATA -> CAGGTAACTTACGAGGAACTATAC
CTTAGCACCTTGACGCGAGCTGTA -> TTAGCACCTTGACGCGAGCTGTAC
AGATTGCCTCTTTGCCGGCGCCGC -> GATTGCCTCTTTGCCGGCGCCGCC
GTCCATACATGCATTAAACTAACT -> TCCATACATGCATTAAACTAACTC
CGTCAAAAGAAAAAGGGAAATAAC -> GTCAAAAGAAAAAGGGAAATAACT
GAACTATAGGAATAGAGTTAATCT -> AACTATAGGAATAGAGTTAATCTA
AGCTGTACTGTGCCGCCGGCATAC -> GCTGTACTGTGCCGCCGGCATACG
CAGGTGGCTCAGGTAACTTACGAG -> AGGTGGCTCAGGTAACTTACGAGG
GACTAAGCCCGGGTTACCAAGTTG -> ACTAAGCCCGGGTTACCAAGTTGC
GTGGTAGATTCATGACCATTTCGT -> TGGTAGATTCATGACCATTTCGTT
CATCTGAGTCAGCGTGTCTTTTTG -> ATCTGAGTCAGCGTGTCTTTTTGA
CCCAAAAGTCTTAGACAGAGTAGC -> CCAAAAGTCTTAGACAGAGTAGCA
TGCTTGTTTCACTACCCTCTTAAG -> GCTTGTTTCACTACCCTCTTAAGC
CGCTGCTTCCCTCCGTCCATAGTC -> GCTGCTTCCCTCCGTCCATAGTCT
TAGTAGTCCCTCGCACAGGTACTC -> AGTAGTCCCTCGCACAGGTACTCT
ACTACGGTAGCTCACCATTGAAGT -> CTACGGTAGCTCACCATTGAAGTA
AGGAATAGGCGCTGAGATGCCCGA -> GGAATAGGCGCTGAGATGCCCGAG
TCCAGAACCCTGAATAACAGGGCA -> CCAGAACCCTGAATAACAGGGCAC
AATATATTCGGGCGTGGGAACGTT -> ATATATTCGGGCGTGGGAACGTTG
CTCTTGGGAAGTTAGAGATGGCTC -> TCTTGGGAAGTTAGAGATGGCTCT
GGACACTTGCTACTGCCATGTTTG -> GACACTTGCTACTGCCATGTTTGC
AAATCCAGAACCCTGAATAACAGG -> AATCCAGAACCCTGAATAACAGGG
TCTTAAGCTACTAAAGAACCAGGT -> CTTAAGCTACTAAAGAACCAGGTC
CCCCTATCCGGACAACTGTAACCA -> CCCTATCCGGACAACTGTAACCAA
GCCAACGCCGCGTAATCATAGGAC -> CCAACGCCGCGTAATCATAGGACG
TTTCGGTCTACATGTCCGGGGAGA -> TTCGGTCTACATGTCCGGGGAGAT
CGGCATACGTCCTGTGAGACAGTG -> GGCATACGTCCTGTGAGACAGTGG
CCCCTGAGGTTGAAAAATTGCTCG -> CCCTGAGGTTGAAAAATTGCTCGA
ATTCGGGCGTGGGAACGTTGTCTA -> TTCGGGCGTGGGAACGTTGTCTAT
TGTCTGTTAAGGGGAGCTCGCTAA -> GTCTGTTAAGGGGAGCTCGCTAAG
ACCTTAATTAATGCACAGTCTGAG -> CCTTAATTAATGCACAGTCTGAGA
ACGGGGGAATTCGTCAAAAGAAAA -> CGGGGGAATTCGTCAAAAGAAAAA
AAGTTAGAGATGGCTCTCACTGTC -> AGTTAGAGATGGCTCTCACTGTCC
CCATTTCGTTGTATGAGACCGTGC -> CATTTCGTTGTATGAGACCGTGCG
TTACGCTTAATCCCACCATCGTTA -> TACGCTTAATCCCACCATCGTTAT
CAGGTCAGCCGACAATGCCCCATG -> AGGTCAGCCGACAATGCCCCATGC
TATCCGGACAACTGTAACCAAAAC -> ATCCGGACAACTGTAACCAAAACC
GAAAGTTTGGAGTCAGAGAATTAC -> AAAGTTTGGAGTCAGAGAATTACG
GGGCGCCCCTCCCAAAAGTCTTAG -> GGCGCCCCTCCCAAAAGTCTTAGA
ACGAGGATAGTGCTTTATCTGTTA -> CGAGGATAGTGCTTTATCTGTTAG
GCTCGCTAAGCCCTCCCCCTGAGG -> CTCGCTAAGCCCTCCCCCTGAGGT
AACGCCGCGTAATCATAGGACGTT -> ACGCCGCGTAATCATAGGACGTTG
AGACGTGGTAGATTCATGACCATT -> GACGTGGTAGATTCATGACCATTT
AATTCGTCTTCGGGCCTTTCGGTC -> ATTCGTCTTCGGGCCTTTCGGTCT
CTATATTTTGCAAACACAATGAGC -> TATATTTTGCAAACACAATGAGCG
TCAGCGTGTCTTTTTGATAAGTCG -> CAGCGTGTCTTTTTGATAAGTCGT
TTGTTATCCGGATTGATCTCGCCG -> TGTTATCCGGATTGATCTCGCCGG
CATGCATTAAACTAACTCAATGAG -> ATGCATTAAACTAACTCAATGAGG
TCCGAAATTTGTTATCCGGATTGA -> CCGAAATTTGTTATCCGGATTGAT
CGTTGTATGAGACCGTGCGATGCG -> GTTGTATGAGACCGTGCGATGCGC
AATGCACAGTCTGAGAAAGTTTGG -> ATGCACAGTCTGAGAAAGTTTGGA
TGTTTGGCCTATTGGCGCCAAGAG -> GTTTGGCCTATTGGCGCCAAGAGC
TGCGCAGAATCCTGACGGCCCCCC -> GCGCAGAATCCTGACGGCCCCCCA
TAGAGTTAATCTATGAATGTCCAT -> AGAGTTAATCTATGAATGTCCATA
GTGACTCCGAAATTTGTTATCCGG -> TGACTCCGAAATTTGTTATCCGGA
ACTGCCATGTTTGCTTCTCAGGTA -> CTGCCATGTTTGCTTCTCAGGTAC
GTGCTAGCGATAGGTCATCAAGAA -> TGCTAGCGATAGGTCATCAAGAAA
ATAACTATAGTGAGGTACGAAAGT -> TAACTATAGTGAGGTACGAAAGTG
TGTCTATTGGCACCGAATACCGAA -> GTCTATTGGCACCGAATACCGAAC
TAGGGTCGACCTCTGGGCGCCCCT -> AGGGTCGACCTCTGGGCGCCCCTC
TCTTGAAAATTAAAGGGTTCACGC -> CTTGAAAATTAAAGGGTTCACGCC
GCCGAGCGACAGCGAAGCAGTTAA -> CCGAGCGACAGCGAAGCAGTTAAT
CTAAGTACTGGTAACTGTTTGGCC -> TAAGTACTGGTAACTGTTTGGCCT
CGAATTAATTGTGCCGAGCGACAG -> GAATTAATTGTGCCGAGCGACAGC
CTAAGCCCGGGTTACCAAGTTGCT -> TAAGCCCGGGTTACCAAGTTGCTC
AAGTCGTTGCACCAGACGTTCATG -> AGTCGTTGCACCAGACGTTCATGC
ACCTCGCGTTGTCTGCTAGTGAGC -> CCTCGCGTTGTCTGCTAGTGAGCT
TCTTAGACAGAGTAGCAACGTTTG -> CTTAGACAGAGTAGCAACGTTTGG
CAATGAGGAATAGGCGCTGAGATG -> AATGAGGAATAGGCGCTGAGATGC
CGTTGTCTATTGGCACCGAATACC -> GTTGTCTATTGGCACCGAATACCG
AGCGATAGGTCATCAAGAAAGGCC -> GCGATAGGTCATCAAGAAAGGCCC
CCCAACTCCGGGTCCTGCTAGGGA -> CCAACTCCGGGTCCTGCTAGGGAT
CTGTTAAGGGGAGCTCGCTAAGCC -> TGTTAAGGGGAGCTCGCTAAGCCC
TAGCAACGTTTGGCTCTATTGTCT -> AGCAACGTTTGGCTCTATTGTCTG
ATTGGCGCCAAGAGCTTTCATCTG -> TTGGCGCCAAGAGCTTTCATCTGA
AGAATTACGTATGACACTCACATT -> GAATTACGTATGACACTCACATTG
ACCCTCTTAAGCTACTAAAGAACC -> CCCTCTTAAGCTACTAAAGAACCA
GCGACAGTGATAGTAAACCTCGCG -> CGACAGTGATAGTAAACCTCGCGT
CTGTTAGGTACACCTTCTCTTGTT -> TGTTAGGTACACCTTCTCTTGTTT
ACGCACGGTCCTCCTACCTATGCC -> CGCACGGTCCTCCTACCTATGCCG
GATAAGTCGTTGCACCAGACGTTC -> ATAAGTCGTTGCACCAGACGTTCA
TGCCGGTAATTTCTCGTGGCCTAG -> GCCGGTAATTTCTCGTGGCCTAGA
ACTGCGCAGAATCCTGACGGCCCC -> CTGCGCAGAATCCTGACGGCCCCC
CCGGATTGATCTCGCCGGTTCGAG -> CGGATTGATCTCGCCGGTTCGAGA
TCCGGGTCCTGCTAGGGATCAGAC -> CCGGGTCCTGCTAGGGATCAGACG
CGGGGAGATTGCCTCTTTGCCGGC -> GGGGAGATTGCCTCTTTGCCGGCG
ACCAGGTCAGCCGACAATGCCCCA -> CCAGGTCAGCCGACAATGCCCCAT
AACACAATGAGCGCTGCTTCCCTC -> ACACAATGAGCGCTGCTTCCCTCC
ACGTCCTGTGAGACAGTGGCCTAT -> CGTCCTGTGAGACAGTGGCCTATA
CTCTTAGCACCTTGACGCGAGCTG -> TCTTAGCACCTTGACGCGAGCTGT
CCGGGTCCTGCTAGGGATCAGACG -> CGGGTCCTGCTAGGGATCAGACGA
CCTCCCAAAAGTCTTAGACAGAGT -> CTCCCAAAAGTCTTAGACAGAGTA
CTATGCCGGTAATTTCTCGTGGCC -> TATGCCGGTAATTTCTCGTGGCCT
GAACATTGCGACAGTGATAGTAAA -> AACATTGCGACAGTGATAGTAAAC
GCCCAGTGCAAGGGCACACACGTT -> CCCAGTGCAAGGGCACACACGTTT
AAGTTGCTCAACGCGGTCTTTCTA -> AGTTGCTCAACGCGGTCTTTCTAA
TATAGTGAGGTACGAAAGTGCTAG -> ATAGTGAGGTACGAAAGTGCTAGC
AAATTAAAGGGTTCACGCCGTGGA -> AATTAAAGGGTTCACGCCGTGGAC
TTGCTTGTTTCACTACCCTCTTAA -> TGCTTGTTTCACTACCCTCTTAAG
GAATAGAGTTAATCTATGAATGTC -> AATAGAGTTAATCTATGAATGTCC
AACCATCCCCCTATCCGGACAACT -> ACCATCCCCCTATCCGGACAACTG
CGACCTCTGGGCGCCCCTCCCAAA -> GACCTCTGGGCGCCCCTCCCAAAA
CTATAGGAATAGAGTTAATCTATG -> TATAGGAATAGAGTTAATCTATGA
CATCGTTATAAATGAAAGGGATCT -> ATCGTTATAAATGAAAGGGATCTG
GCTCTTACGCTTAATCCCACCATC -> CTCTTACGCTTAATCCCACCATCG
AGTTAATATATTCGGGCGTGGGAA -> GTTAATATATTCGGGCGTGGGAAC
GCCCCTCCCAAAAGTCTTAGACAG -> CCCCTCCCAAAAGTCTTAGACAGA
CTTGATTAAATCCAGAACCCTGAA -> TTGATTAAATCCAGAACCCTGAAT
TAGACGTGGTAGATTCATGACCAT -> AGACGTGGTAGATTCATGACCATT
GCACGGTCCTCCTACCTATGCCGG -> CACGGTCCTCCTACCTATGCCGGT
CGGACAACTGTAACCAAAACCGAT -> GGACAACTGTAACCAAAACCGATA
TGACCATTTCGTTGTATGAGACCG -> GACCATTTCGTTGTATGAGACCGT
CTGCTAGGGATCAGACGATGGGAT -> TGCTAGGGATCAGACGATGGGATC
GGTTCGAGAAGGGAGCATTTTCAG -> GTTCGAGAAGGGAGCATTTTCAGA
ACGCTATATTTTGCAAACACAATG -> CGCTATATTTTGCAAACACAATGA
CACACGTTTTACAGGTCGATACGC -> ACACGTTTTACAGGTCGATACGCG
ACGGTAGCTCACCATTGAAGTAGA -> CGGTAGCTCACCATTGAAGTAGAA
GGGAACGTTGTCTATTGGCACCGA -> GGAACGTTGTCTATTGGCACCGAA
CCCAGTGCAAGGGCACACACGTTT -> CCAGTGCAAGGGCACACACGTTTT
CTTACGAGGAACTATACGGGCCAA -> TTACGAGGAACTATACGGGCCAAC
CTGTCCAATGTCATCTCTGACCGG -> TGTCCAATGTCATCTCTGACCGGA
TGGCTCAGGTAACTTACGAGGAAC -> GGCTCAGGTAACTTACGAGGAACT
GCCGGTTCGAGAAGGGAGCATTTT -> CCGGTTCGAGAAGGGAGCATTTTC
CGTTGTCTGCTAGTGAGCTCTTAC -> GTTGTCTGCTAGTGAGCTCTTACG
AATTTGTTATCCGGATTGATCTCG -> ATTTGTTATCCGGATTGATCTCGC
GGTCCTCCTACCTATGCCGGTAAT -> GTCCTCCTACCTATGCCGGTAATT
CGCCGTGGACACTTGCTACTGCCA -> GCCGTGGACACTTGCTACTGCCAT
ATAATAACTTCACCCTAGGGTCGA -> TAATAACTTCACCCTAGGGTCGAC
TAATAACTTCACCCTAGGGTCGAC -> AATAACTTCACCCTAGGGTCGACC
AATTCGTCAAAAGAAAAAGGGAAA -> ATTCGTCAAAAGAAAAAGGGAAAT
ACTCTTAGCACCTTGACGCGAGCT -> CTCTTAGCACCTTGACGCGAGCTG
TACTCTTAGCACCTTGACGCGAGC -> ACTCTTAGCACCTTGACGCGAGCT
CGGCGCCGCCCGGGCCCGGCAAGG -> GGCGCCGCCCGGGCCCGGCAAGGC
AAGTCTTAGACAGAGTAGCAACGT -> AGTCTTAGACAGAGTAGCAACGTT
ACCAAGTTGCTCAACGCGGTCTTT -> CCAAGTTGCTCAACGCGGTCTTTC
CTCCGGGTCCTGCTAGGGATCAGA -> TCCGGGTCCTGCTAGGGATCAGAC
CTTTGAGCGCACAGAAATATAGTC -> TTTGAGCGCACAGAAATATAGTCG
GGGAGATTGCCTCTTTGCCGGCGC -> GGAGATTGCCTCTTTGCCGGCGCC
TGGCTCTATTGTCTGTTAAGGGGA -> GGCTCTATTGTCTGTTAAGGGGAG
TCCGTCCATAGTCTGACAGGTGGC -> CCGTCCATAGTCTGACAGGTGGCT
GCCCCATGCCCTCGAGTGGAGGGG -> CCCCATGCCCTCGAGTGGAGGGGG
GGAGATTGCCTCTTTGCCGGCGCC -> GAGATTGCCTCTTTGCCGGCGCCG
GCCGCCGGCATACGTCCTGTGAGA -> CCGCCGGCATACGTCCTGTGAGAC
GGGATCTCAAAGCAAATCCCTATA -> GGATCTCAAAGCAAATCCCTATAG
ATGTGGCTCTTCTATTTGAGGCAG -> TGTGGCTCTTCTATTTGAGGCAGA
GATACGCGGCTTTTGGATATACAG -> ATACGCGGCTTTTGGATATACAGA
AAGTACTGGTAACTGTTTGGCCTA -> AGTACTGGTAACTGTTTGGCCTAT
CTCACCATTGAAGTAGAATAATCA -> TCACCATTGAAGTAGAATAATCAA
ACTCCGAAATTTGTTATCCGGATT -> CTCCGAAATTTGTTATCCGGATTG
GTTGTCTGCTAGTGAGCTCTTACG -> TTGTCTGCTAGTGAGCTCTTACGC
ACGCGGCTTTTGGATATACAGATT -> CGCGGCTTTTGGATATACAGATTT
TAAATCACTGCAGCGCTGCTACTC -> AAATCACTGCAGCGCTGCTACTCA
TCTGAGAAAGTTTGGAGTCAGAGA -> CTGAGAAAGTTTGGAGTCAGAGAA
TAATGCACAGTCTGAGAAAGTTTG -> AATGCACAGTCTGAGAAAGTTTGG
CTACATGTCCGGGGAGATTGCCTC -> TACATGTCCGGGGAGATTGCCTCT
CGACAATGCCCCATGCCCTCGAGT -> GACAATGCCCCATGCCCTCGAGTG
AAAACCGATACTATCAAATTCCGA -> AAACCGATACTATCAAATTCCGAT
CCTCGAGTGGAGGGGGCTCTTGGG -> CTCGAGTGGAGGGGGCTCTTGGGA
TTTCGTTGTATGAGACCGTGCGAT -> TTCGTTGTATGAGACCGTGCGATG
GGATTGATCTCGCCGGTTCGAGAA -> GATTGATCTCGCCGGTTCGAGAAG
GAGGTTGAAAAATTGCTCGAAACT -> AGGTTGAAAAATTGCTCGAAACTA
CTCACTTGATTAAATCCAGAACCC -> TCACTTGATTAAATCCAGAACCCT
AAAAATTGCTCGAAACTAAGTACT -> AAAATTGCTCGAAACTAAGTACTG
CTTGTTTCACTACCCTCTTAAGCT -> TTGTTTCACTACCCTCTTAAGCTA
GATAGTGCTTTATCTGTTAGGTAC -> ATAGTGCTTTATCTGTTAGGTACA
TGAATAACAGGGCACTGCGCAGAA -> GAATAACAGGGCACTGCGCAGAAT
AATTGCTCGAAACTAAGTACTGGT -> ATTGCTCGAAACTAAGTACTGGTA
CGGTCTTTCTAAAATTCGTCTTCG -> GGTCTTTCTAAAATTCGTCTTCGG
CCCTCTTAAGCTACTAAAGAACCA -> CCTCTTAAGCTACTAAAGAACCAG
TCTGGGCGCCCCTCCCAAAAGTCT -> CTGGGCGCCCCTCCCAAAAGTCTT
CGCGGTCTTTCTAAAATTCGTCTT -> GCGGTCTTTCTAAAATTCGTCTTC
CTCAACGCGGTCTTTCTAAAATTC -> TCAACGCGGTCTTTCTAAAATTCG
CACCATTGAAGTAGAATAATCAAT -> ACCATTGAAGTAGAATAATCAATA
CCTCGCGTTGTCTGCTAGTGAGCT -> CTCGCGTTGTCTGCTAGTGAGCTC
GTGCTTTATCTGTTAGGTACACCT -> TGCTTTATCTGTTAGGTACACCTT
CGTTCATGCCCTGGTGGCAGCTTT -> GTTCATGCCCTGGTGGCAGCTTTG
TATTGGCACCGAATACCGAACATT -> ATTGGCACCGAATACCGAACATTG
GAGACGCAGCAATGTGGCTCTTCT -> AGACGCAGCAATGTGGCTCTTCTA
TTCCGATCTCTCACTTGATTAAAT -> TCCGATCTCTCACTTGATTAAATC
AGGTAACTTACGAGGAACTATACG -> GGTAACTTACGAGGAACTATACGG
CCTATCCGGACAACTGTAACCAAA -> CTATCCGGACAACTGTAACCAAAA
CATGACCATTTCGTTGTATGAGAC -> ATGACCATTTCGTTGTATGAGACC
TAAATGAAAGGGATCTGAGACGCA -> AAATGAAAGGGATCTGAGACGCAG
TCGACGCTACTACGGTAGCTCACC -> CGACGCTACTACGGTAGCTCACCA
CGGAGTCAGCATCGAATTAATTGT -> GGAGTCAGCATCGAATTAATTGTG
AGTTAATCTATGAATGTCCATACA -> GTTAATCTATGAATGTCCATACAT
CAAATCCCTATAGCCCATCAGAAC -> AAATCCCTATAGCCCATCAGAACG
TTTCTCGTGGCCTAGACGTGGTAG -> TTCTCGTGGCCTAGACGTGGTAGA
GCTAGTGAGCTCTTACGCTTAATC -> CTAGTGAGCTCTTACGCTTAATCC
CGAGTGGAGGGGGCTCTTGGGAAG -> GAGTGGAGGGGGCTCTTGGGAAGT
CTATACGGGCCAACGCCGCGTAAT -> TATACGGGCCAACGCCGCGTAATC
CTCTTAAGCTACTAAAGAACCAGG -> TCTTAAGCTACTAAAGAACCAGGT
CACTGCAGCGCTGCTACTCACCTT -> ACTGCAGCGCTGCTACTCACCTTA
GTAGCAACGTTTGGCTCTATTGTC -> TAGCAACGTTTGGCTCTATTGTCT
ATTCCGATCTCTCACTTGATTAAA -> TTCCGATCTCTCACTTGATTAAAT
AATGCCCCATGCCCTCGAGTGGAG -> ATGCCCCATGCCCTCGAGTGGAGG
TGGCGCCAAGAGCTTTCATCTGAG -> GGCGCCAAGAGCTTTCATCTGAGT
ATAGGACGTTGTAAATCACTGCAG -> TAGGACGTTGTAAATCACTGCAGC
GCCATGTTTGCTTCTCAGGTACGC -> CCATGTTTGCTTCTCAGGTACGCT
GTCTACATGTCCGGGGAGATTGCC -> TCTACATGTCCGGGGAGATTGCCT
TCAGCCGACAATGCCCCATGCCCT -> CAGCCGACAATGCCCCATGCCCTC
AAAATTCGTCTTCGGGCCTTTCGG -> AAATTCGTCTTCGGGCCTTTCGGT
TGCTAGCGATAGGTCATCAAGAAA -> GCTAGCGATAGGTCATCAAGAAAG
GGAAATAACTATAGTGAGGTACGA -> GAAATAACTATAGTGAGGTACGAA
ATGTTTGCTTCTCAGGTACGCTAT -> TGTTTGCTTCTCAGGTACGCTATA
AATTGTGCCGAGCGACAGCGAAGC -> ATTGTGCCGAGCGACAGCGAAGCA
TCCATAGTCTGACAGGTGGCTCAG -> CCATAGTCTGACAGGTGGCTCAGG
GGCTCAGGTAACTTACGAGGAACT -> GCTCAGGTAACTTACGAGGAACTA
TTGCACCAGACGTTCATGCCCTGG -> TGCACCAGACGTTCATGCCCTGGT
TGCATTAAACTAACTCAATGAGGA -> GCATTAAACTAACTCAATGAGGAA
AAATTCCGATCTCTCACTTGATTA -> AATTCCGATCTCTCACTTGATTAA
TCACATTGCCGGAACTATAGGAAT -> CACATTGCCGGAACTATAGGAATA
ACGGTCCTCCTACCTATGCCGGTA -> CGGTCCTCCTACCTATGCCGGTAA
ATCAGACGATGGGATCTCAAAGCA -> TCAGACGATGGGATCTCAAAGCAA
AGTAAACTGCGAAATAAACTGCGG -> GTAAACTGCGAAATAAACTGCGGT
CCAGAACCCTGAATAACAGGGCAC -> CAGAACCCTGAATAACAGGGCACT
CCTGCTAGGGATCAGACGATGGGA -> CTGCTAGGGATCAGACGATGGGAT
CAGGTACGCTATATTTTGCAAACA -> AGGTACGCTATATTTTGCAAACAC
ATCAAATTCCGATCTCTCACTTGA -> TCAAATTCCGATCTCTCACTTGAT
CGGCCCCCCAACTCCGGGTCCTGC -> GGCCCCCCAACTCCGGGTCCTGCT
AACGAGACGAGGATAGTGCTTTAT -> ACGAGACGAGGATAGTGCTTTATC
GTATGAGACCGTGCGATGCGCATC -> TATGAGACCGTGCGATGCGCATCG
TGGCTCTTCTATTTGAGGCAGACT -> GGCTCTTCTATTTGAGGCAGACTA
GATTAAATCCAGAACCCTGAATAA -> ATTAAATCCAGAACCCTGAATAAC
CCTATGCCGGTAATTTCTCGTGGC -> CTATGCCGGTAATTTCTCGTGGCC
TAAAATTCGTCTTCGGGCCTTTCG -> AAAATTCGTCTTCGGGCCTTTCGG
TGGGAAGTTAGAGATGGCTCTCAC -> GGGAAGTTAGAGATGGCTCTCACT
TACGTGACTCCGAAATTTGTTATC -> ACGTGACTCCGAAATTTGTTATCC
TCCCTATAGCCCATCAGAACGAGA -> CCCTATAGCCCATCAGAACGAGAC
GACCGGATAATAACTTCACCCTAG -> ACCGGATAATAACTTCACCCTAGG
ATTGCGACAGTGATAGTAAACCTC -> TTGCGACAGTGATAGTAAACCTCG
ACCGTGCGATGCGCATCGGAGTCA -> CCGTGCGATGCGCATCGGAGTCAG
CATTGAAGTAGAATAATCAATACG -> ATTGAAGTAGAATAATCAATACGG
TGGTGGCAGCTTTGAGCGCACAGA -> GGTGGCAGCTTTGAGCGCACAGAA
ACTGCGAAATAAACTGCGGTCAAC -> CTGCGAAATAAACTGCGGTCAACC
GCAATGTGGCTCTTCTATTTGAGG -> CAATGTGGCTCTTCTATTTGAGGC
CAAGGCCTCTTGAAAATTAAAGGG -> AAGGCCTCTTGAAAATTAAAGGGT
ATAGGCGCTGAGATGCCCGAGTGA -> TAGGCGCTGAGATGCCCGAGTGAC
CTTTCTAAAATTCGTCTTCGGGCC -> TTTCTAAAATTCGTCTTCGGGCCT
TGAGCGCTGCTTCCCTCCGTCCAT -> GAGCGCTGCTTCCCTCCGTCCATA
AAGAAAAAGGGAAATAACTATAGT -> AGAAAAAGGGAAATAACTATAGTG
ATAGTAAACCTCGCGTTGTCTGCT -> TAGTAAACCTCGCGTTGTCTGCTA
GGATAATAACTTCACCCTAGGGTC -> GATAATAACTTCACCCTAGGGTCG
GCCGGTAATTTCTCGTGGCCTAGA -> CCGGTAATTTCTCGTGGCCTAGAC
GTCCTGTGAGACAGTGGCCTATAA -> TCCTGTGAGACAGTGGCCTATAAC
GCTACTAAAGAACCAGGTCAGCCG -> CTACTAAAGAACCAGGTCAGCCGA
CTGCTACTCACCTTAATTAATGCA -> TGCTACTCACCTTAATTAATGCAC
GGGCACACACGTTTTACAGGTCGA -> GGCACACACGTTTTACAGGTCGAT
AGCATTTTCAGATTGCTTGTTTCA -> GCATTTTCAGATTGCTTGTTTCAC
CTGTACTGTGCCGCCGGCATACGT -> TGTACTGTGCCGCCGGCATACGTC
GGATCAGACGATGGGATCTCAAAG -> GATCAGACGATGGGATCTCAAAGC
CCACCATCGTTATAAATGAAAGGG -> CACCATCGTTATAAATGAAAGGGA
GCTATATTTTGCAAACACAATGAG -> CTATATTTTGCAAACACAATGAGC
CCATGTTTGCTTCTCAGGTACGCT -> CATGTTTGCTTCTCAGGTACGCTA
TTGAAGTAGAATAATCAATACGGG -> TGAAGTAGAATAATCAATACGGGG
GAGGCAGACTAAGCCCGGGTTACC -> AGGCAGACTAAGCCCGGGTTACCA
GTAGTCCCTCGCACAGGTACTCTT -> TAGTCCCTCGCACAGGTACTCTTA
TAGAGATGGCTCTCACTGTCCAAT -> AGAGATGGCTCTCACTGTCCAATG
TGAGCACTAGTAGTCCCTCGCACA -> GAGCACTAGTAGTCCCTCGCACAG
AGGCGCTGAGATGCCCGAGTGACG -> GGCGCTGAGATGCCCGAGTGACGG
GTTAATATATTCGGGCGTGGGAAC -> TTAATATATTCGGGCGTGGGAACG
CACTGCGCAGAATCCTGACGGCCC -> ACTGCGCAGAATCCTGACGGCCCC
TTGGATATACAGATTTGTGAGCAC -> TGGATATACAGATTTGTGAGCACT
GTGATAGTAAACCTCGCGTTGTCT -> TGATAGTAAACCTCGCGTTGTCTG
GTCGACCTCTGGGCGCCCCTCCCA -> TCGACCTCTGGGCGCCCCTCCCAA
GAGTAGCAACGTTTGGCTCTATTG -> AGTAGCAACGTTTGGCTCTATTGT
TGGAGGGGGCTCTTGGGAAGTTAG -> GGAGGGGGCTCTTGGGAAGTTAGA
GCGCATCGGAGTCAGCATCGAATT -> CGCATCGGAGTCAGCATCGAATTA
ATTCGTCAAAAGAAAAAGGGAAAT -> TTCGTCAAAAGAAAAAGGGAAATA
ATATATTCGGGCGTGGGAACGTTG -> TATATTCGGGCGTGGGAACGTTGT
TAATATATTCGGGCGTGGGAACGT -> AATATATTCGGGCGTGGGAACGTT
GTAATCATAGGACGTTGTAAATCA -> TAATCATAGGACGTTGTAAATCAC
CTCTGACCGGATAATAACTTCACC -> TCTGACCGGATAATAACTTCACCC
TGACACTCACATTGCCGGAACTAT -> GACACTCACATTGCCGGAACTATA
ACGGGCTAGTAAACTGCGAAATAA -> CGGGCTAGTAAACTGCGAAATAAA
CAAAACCGATACTATCAAATTCCG -> AAAACCGATACTATCAAATTCCGA
CTCAAAGCAAATCCCTATAGCCCA -> TCAAAGCAAATCCCTATAGCCCAT
ACTATAGGAATAGAGTTAATCTAT -> CTATAGGAATAGAGTTAATCTATG
AAACTGCGAAATAAACTGCGGTCA -> AACTGCGAAATAAACTGCGGTCAA
GTCTGACAGGTGGCTCAGGTAACT -> TCTGACAGGTGGCTCAGGTAACTT
ACACACGTTTTACAGGTCGATACG -> CACACGTTTTACAGGTCGATACGC
GGGGCTCTTGGGAAGTTAGAGATG -> GGGCTCTTGGGAAGTTAGAGATGG
GCACAGTCTGAGAAAGTTTGGAGT -> CACAGTCTGAGAAAGTTTGGAGTC
CAGATTGCTTGTTTCACTACCCTC -> AGATTGCTTGTTTCACTACCCTCT
CATTAAACTAACTCAATGAGGAAT -> ATTAAACTAACTCAATGAGGAATA
ATACATGCATTAAACTAACTCAAT -> TACATGCATTAAACTAACTCAATG
GTTAATCTATGAATGTCCATACAT -> TTAATCTATGAATGTCCATACATG
GGCGCCCCTCCCAAAAGTCTTAGA -> GCGCCCCTCCCAAAAGTCTTAGAC
AGGTACGCTATATTTTGCAAACAC -> GGTACGCTATATTTTGCAAACACA
GGGGAGCTCGCTAAGCCCTCCCCC -> GGGAGCTCGCTAAGCCCTCCCCCT
GCACTAGTAGTCCCTCGCACAGGT -> CACTAGTAGTCCCTCGCACAGGTA
CCCATCAGAACGAGACGAGGATAG -> CCATCAGAACGAGACGAGGATAGT
GACGCGAGCTGTACTGTGCCGCCG -> ACGCGAGCTGTACTGTGCCGCCGG
CTGCTAGTGAGCTCTTACGCTTAA -> TGCTAGTGAGCTCTTACGCTTAAT
ACAGCGAAGCAGTTAATATATTCG -> CAGCGAAGCAGTTAATATATTCGG
TCAACCATCCCCCTATCCGGACAA -> CAACCATCCCCCTATCCGGACAAC
TCAGAGAATTACGTATGACACTCA -> CAGAGAATTACGTATGACACTCAC
CTCGAGTGGAGGGGGCTCTTGGGA -> TCGAGTGGAGGGGGCTCTTGGGAA
CTTCTATTTGAGGCAGACTAAGCC -> TTCTATTTGAGGCAGACTAAGCCC
TCTATTGGCACCGAATACCGAACA -> CTATTGGCACCGAATACCGAACAT
TTACCAAGTTGCTCAACGCGGTCT -> TACCAAGTTGCTCAACGCGGTCTT
AGGGGAGCTCGCTAAGCCCTCCCC -> GGGGAGCTCGCTAAGCCCTCCCCC
GCCGGAACTATAGGAATAGAGTTA -> CCGGAACTATAGGAATAGAGTTAA
CGTTGTAAATCACTGCAGCGCTGC -> GTTGTAAATCACTGCAGCGCTGCT
GTTTCACTACCCTCTTAAGCTACT -> TTTCACTACCCTCTTAAGCTACTA
TGAGACCGTGCGATGCGCATCGGA -> GAGACCGTGCGATGCGCATCGGAG
ACTGGTAACTGTTTGGCCTATTGG -> CTGGTAACTGTTTGGCCTATTGGC
AATTCCGATCTCTCACTTGATTAA -> ATTCCGATCTCTCACTTGATTAAA
ATAGTCTGACAGGTGGCTCAGGTA -> TAGTCTGACAGGTGGCTCAGGTAA
ATCACTGCAGCGCTGCTACTCACC -> TCACTGCAGCGCTGCTACTCACCT
GATGGCTCTCACTGTCCAATGTCA -> ATGGCTCTCACTGTCCAATGTCAT
AAATTTGTTATCCGGATTGATCTC -> AATTTGTTATCCGGATTGATCTCG
GCAGCGCTGCTACTCACCTTAATT -> CAGCGCTGCTACTCACCTTAATTA
GAAATAACTATAGTGAGGTACGAA -> AAATAACTATAGTGAGGTACGAAA
CTTAGACAGAGTAGCAACGTTTGG -> TTAGACAGAGTAGCAACGTTTGGC
ACAGTGATAGTAAACCTCGCGTTG -> CAGTGATAGTAAACCTCGCGTTGT
GAGCTCTTACGCTTAATCCCACCA -> AGCTCTTACGCTTAATCCCACCAT
TCTACATGTCCGGGGAGATTGCCT -> CTACATGTCCGGGGAGATTGCCTC
AGTTAGAGATGGCTCTCACTGTCC -> GTTAGAGATGGCTCTCACTGTCCA
CCAACGCCGCGTAATCATAGGACG -> CAACGCCGCGTAATCATAGGACGT
TCCCAAAAGTCTTAGACAGAGTAG -> CCCAAAAGTCTTAGACAGAGTAGC
GGCAAGGCCTCTTGAAAATTAAAG -> GCAAGGCCTCTTGAAAATTAAAGG
AGCATCGAATTAATTGTGCCGAGC -> GCATCGAATTAATTGTGCCGAGCG
AGCCCATCAGAACGAGACGAGGAT -> GCCCATCAGAACGAGACGAGGATA
GCGCTGAGATGCCCGAGTGACGGG -> CGCTGAGATGCCCGAGTGACGGGC
AGGTACTCTTAGCACCTTGACGCG -> GGTACTCTTAGCACCTTGACGCGA
ATCAAGAAAGGCCCAGTGCAAGGG -> TCAAGAAAGGCCCAGTGCAAGGGC
CTCAATGAGGAATAGGCGCTGAGA -> TCAATGAGGAATAGGCGCTGAGAT
GTTTGGAGTCAGAGAATTACGTAT -> TTTGGAGTCAGAGAATTACGTATG
TGAAGTAGAATAATCAATACGGGG -> GAAGTAGAATAATCAATACGGGGG
TAAACCTCGCGTTGTCTGCTAGTG -> AAACCTCGCGTTGTCTGCTAGTGA
AGGACGTTGTAAATCACTGCAGCG -> GGACGTTGTAAATCACTGCAGCGC
GATCAGACGATGGGATCTCAAAGC -> ATCAGACGATGGGATCTCAAAGCA
AGGTACACCTTCTCTTGTTTGGCT -> GGTACACCTTCTCTTGTTTGGCTC
CAGGTAACTTACGAGGAACTATAC -> AGGTAACTTACGAGGAACTATACG
CTGCGGTCAACCATCCCCCTATCC -> TGCGGTCAACCATCCCCCTATCCG
GAACCCTGAATAACAGGGCACTGC -> AACCCTGAATAACAGGGCACTGCG
TTTGCAAACACAATGAGCGCTGCT -> TTGCAAACACAATGAGCGCTGCTT
AACCTCGCGTTGTCTGCTAGTGAG -> ACCTCGCGTTGTCTGCTAGTGAGC
CCGGTAATTTCTCGTGGCCTAGAC -> CGGTAATTTCTCGTGGCCTAGACG
GCGGTCAACCATCCCCCTATCCGG -> CGGTCAACCATCCCCCTATCCGGA
TCACTGTCCAATGTCATCTCTGAC -> CACTGTCCAATGTCATCTCTGACC
GCCCGGCAAGGCCTCTTGAAAATT -> CCCGGCAAGGCCTCTTGAAAATTA
ACTTCACCCTAGGGTCGACCTCTG -> CTTCACCCTAGGGTCGACCTCTGG
CGGCAAGGCCTCTTGAAAATTAAA -> GGCAAGGCCTCTTGAAAATTAAAG
CAACGCCGCGTAATCATAGGACGT -> AACGCCGCGTAATCATAGGACGTT
CACTACCCTCTTAAGCTACTAAAG -> ACTACCCTCTTAAGCTACTAAAGA
CTACTAAAGAACCAGGTCAGCCGA -> TACTAAAGAACCAGGTCAGCCGAC
AAGAAAGGCCCAGTGCAAGGGCAC -> AGAAAGGCCCAGTGCAAGGGCACA
GGCCCAGTGCAAGGGCACACACGT -> GCCCAGTGCAAGGGCACACACGTT
AGAAAGTTTGGAGTCAGAGAATTA -> GAAAGTTTGGAGTCAGAGAATTAC
CACGTTTTACAGGTCGATACGCGG -> ACGTTTTACAGGTCGATACGCGGC
ACGCTTAATCCCACCATCGTTATA -> CGCTTAATCCCACCATCGTTATAA
TACCGAACATTGCGACAGTGATAG -> ACCGAACATTGCGACAGTGATAGT
CTTTGCCGGCGCCGCCCGGGCCCG -> TTTGCCGGCGCCGCCCGGGCCCGG
GCTCAGGTAACTTACGAGGAACTA -> CTCAGGTAACTTACGAGGAACTAT
CAGCCGACAATGCCCCATGCCCTC -> AGCCGACAATGCCCCATGCCCTCG
TTGCAAACACAATGAGCGCTGCTT -> TGCAAACACAATGAGCGCTGCTTC
GGTCGATACGCGGCTTTTGGATAT -> GTCGATACGCGGCTTTTGGATATA
GCCCGAGTGACGGGCTAGTAAACT -> CCCGAGTGACGGGCTAGTAAACTG
GCGCTGCTACTCACCTTAATTAAT -> CGCTGCTACTCACCTTAATTAATG
AGTCTGACAGGTGGCTCAGGTAAC -> GTCTGACAGGTGGCTCAGGTAACT
TAATCCCACCATCGTTATAAATGA -> AATCCCACCATCGTTATAAATGAA
GTCATCAAGAAAGGCCCAGTGCAA -> TCATCAAGAAAGGCCCAGTGCAAG
AACCAAAACCGATACTATCAAATT -> ACCAAAACCGATACTATCAAATTC
CAAGTTGCTCAACGCGGTCTTTCT -> AAGTTGCTCAACGCGGTCTTTCTA
CGGTCCTCCTACCTATGCCGGTAA -> GGTCCTCCTACCTATGCCGGTAAT
CCATTGAAGTAGAATAATCAATAC -> CATTGAAGTAGAATAATCAATACG
ATCTCAAAGCAAATCCCTATAGCC -> TCTCAAAGCAAATCCCTATAGCCC
CAGAACCCTGAATAACAGGGCACT -> AGAACCCTGAATAACAGGGCACTG
AGAACCAGGTCAGCCGACAATGCC -> GAACCAGGTCAGCCGACAATGCCC
ACGTTTTACAGGTCGATACGCGGC -> CGTTTTACAGGTCGATACGCGGCT
ATGCCCTGGTGGCAGCTTTGAGCG -> TGCCCTGGTGGCAGCTTTGAGCGC
TGCGAAATAAACTGCGGTCAACCA -> GCGAAATAAACTGCGGTCAACCAT
CGTAATCATAGGACGTTGTAAATC -> GTAATCATAGGACGTTGTAAATCA
GGAATAGGCGCTGAGATGCCCGAG -> GAATAGGCGCTGAGATGCCCGAGT
TTCGGGCGTGGGAACGTTGTCTAT -> TCGGGCGTGGGAACGTTGTCTATT
AGACAGAGTAGCAACGTTTGGCTC -> GACAGAGTAGCAACGTTTGGCTCT
TCCTGACGGCCCCCCAACTCCGGG -> CCTGACGGCCCCCCAACTCCGGGT
AAGAGCTTTCATCTGAGTCAGCGT -> AGAGCTTTCATCTGAGTCAGCGTG
AGGTCGATACGCGGCTTTTGGATA -> GGTCGATACGCGGCTTTTGGATAT
CTGTGCCGCCGGCATACGTCCTGT -> TGTGCCGCCGGCATACGTCCTGTG
CTTGGGAAGTTAGAGATGGCTCTC -> TTGGGAAGTTAGAGATGGCTCTCA
ACGAGACGAGGATAGTGCTTTATC -> CGAGACGAGGATAGTGCTTTATCT
CAGGTACTCTTAGCACCTTGACGC -> AGGTACTCTTAGCACCTTGACGCG
GGCTCTATTGTCTGTTAAGGGGAG -> GCTCTATTGTCTGTTAAGGGGAGC
GCTTCCCTCCGTCCATAGTCTGAC -> CTTCCCTCCGTCCATAGTCTGACA
CTGTAACCAAAACCGATACTATCA -> TGTAACCAAAACCGATACTATCAA
TCTCAAAGCAAATCCCTATAGCCC -> CTCAAAGCAAATCCCTATAGCCCA
AATCCTGACGGCCCCCCAACTCCG -> ATCCTGACGGCCCCCCAACTCCGG
GTACTCTTAGCACCTTGACGCGAG -> TACTCTTAGCACCTTGACGCGAGC
TACAGGTCGATACGCGGCTTTTGG -> ACAGGTCGATACGCGGCTTTTGGA
AGACGCAGCAATGTGGCTCTTCTA -> GACGCAGCAATGTGGCTCTTCTAT
GGATCTCAAAGCAAATCCCTATAG -> GATCTCAAAGCAAATCCCTATAGC
CGGGCCAACGCCGCGTAATCATAG -> GGGCCAACGCCGCGTAATCATAGG
CTTTTGGATATACAGATTTGTGAG -> TTTTGGATATACAGATTTGTGAGC
ATGAATGTCCATACATGCATTAAA -> TGAATGTCCATACATGCATTAAAC
GCCCGGGTTACCAAGTTGCTCAAC -> CCCGGGTTACCAAGTTGCTCAACG
GCAAGGCCTCTTGAAAATTAAAGG -> CAAGGCCTCTTGAAAATTAAAGGG
CCGGCAAGGCCTCTTGAAAATTAA -> CGGCAAGGCCTCTTGAAAATTAAA
TTGACGCGAGCTGTACTGTGCCGC -> TGACGCGAGCTGTACTGTGCCGCC
GGCGCCGCCCGGGCCCGGCAAGGC -> GCGCCGCCCGGGCCCGGCAAGGCC
CGAGGATAGTGCTTTATCTGTTAG -> GAGGATAGTGCTTTATCTGTTAGG
ATTTCGTTGTATGAGACCGTGCGA -> TTTCGTTGTATGAGACCGTGCGAT
ACCATCGTTATAAATGAAAGGGAT -> CCATCGTTATAAATGAAAGGGATC
TTTGGCCTATTGGCGCCAAGAGCT -> TTGGCCTATTGGCGCCAAGAGCTT
CAGAGAATTACGTATGACACTCAC -> AGAGAATTACGTATGACACTCACA
AGACTAAGCCCGGGTTACCAAGTT -> GACTAAGCCCGGGTTACCAAGTTG
AAAATTAAAGGGTTCACGCCGTGG -> AAATTAAAGGGTTCACGCCGTGGA
AGTAGTCCCTCGCACAGGTACTCT -> GTAGTCCCTCGCACAGGTACTCTT
GTTGAAAAATTGCTCGAAACTAAG -> TTGAAAAATTGCTCGAAACTAAGT
TAAGCTACTAAAGAACCAGGTCAG -> AAGCTACTAAAGAACCAGGTCAGC
AGTGAGGTACGAAAGTGCTAGCGA -> GTGAGGTACGAAAGTGCTAGCGAT
CACAATGAGCGCTGCTTCCCTCCG -> ACAATGAGCGCTGCTTCCCTCCGT
TGGGCGCCCCTCCCAAAAGTCTTA -> GGGCGCCCCTCCCAAAAGTCTTAG
CTATAGCCCATCAGAACGAGACGA -> TATAGCCCATCAGAACGAGACGAG
GCTGAGATGCCCGAGTGACGGGCT -> CTGAGATGCCCGAGTGACGGGCTA
TGCTAGTGAGCTCTTACGCTTAAT -> GCTAGTGAGCTCTTACGCTTAATC
CGGGCCTTTCGGTCTACATGTCCG -> GGGCCTTTCGGTCTACATGTCCGG
CCCGGGCCCGGCAAGGCCTCTTGA -> CCGGGCCCGGCAAGGCCTCTTGAA
GGGAGCTCGCTAAGCCCTCCCCCT -> GGAGCTCGCTAAGCCCTCCCCCTG
CTATAACGCACGGTCCTCCTACCT -> TATAACGCACGGTCCTCCTACCTA
TATATTCGGGCGTGGGAACGTTGT -> ATATTCGGGCGTGGGAACGTTGTC
GGGATCAGACGATGGGATCTCAAA -> GGATCAGACGATGGGATCTCAAAG
TCTTGGGAAGTTAGAGATGGCTCT -> CTTGGGAAGTTAGAGATGGCTCTC
TCTGCTAGTGAGCTCTTACGCTTA -> CTGCTAGTGAGCTCTTACGCTTAA
ACCATTTCGTTGTATGAGACCGTG -> CCATTTCGTTGTATGAGACCGTGC
AGAGCTTTCATCTGAGTCAGCGTG -> GAGCTTTCATCTGAGTCAGCGTGT
TCGAGAAGGGAGCATTTTCAGATT -> CGAGAAGGGAGCATTTTCAGATTG
TACGCTATATTTTGCAAACACAAT -> ACGCTATATTTTGCAAACACAATG
GATATACAGATTTGTGAGCACTAG -> ATATACAGATTTGTGAGCACTAGT
GGCCCGGCAAGGCCTCTTGAAAAT -> GCCCGGCAAGGCCTCTTGAAAATT
CTGAATAACAGGGCACTGCGCAGA -> TGAATAACAGGGCACTGCGCAGAA
CAGTTAATATATTCGGGCGTGGGA -> AGTTAATATATTCGGGCGTGGGAA
TAACTTCACCCTAGGGTCGACCTC -> AACTTCACCCTAGGGTCGACCTCT
AAGGCCTCTTGAAAATTAAAGGGT -> AGGCCTCTTGAAAATTAAAGGGTT
TCCTGCTAGGGATCAGACGATGGG -> CCTGCTAGGGATCAGACGATGGGA
GTATGACACTCACATTGCCGGAAC -> TATGACACTCACATTGCCGGAACT
GAATAGGCGCTGAGATGCCCGAGT -> AATAGGCGCTGAGATGCCCGAGTG
CCCTAGGGTCGACCTCTGGGCGCC -> CCTAGGGTCGACCTCTGGGCGCCC
GCACCTTGACGCGAGCTGTACTGT -> CACCTTGACGCGAGCTGTACTGTG
TGCCATGTTTGCTTCTCAGGTACG -> GCCATGTTTGCTTCTCAGGTACGC
CGCGTTGTCTGCTAGTGAGCTCTT -> GCGTTGTCTGCTAGTGAGCTCTTA
GACAACTGTAACCAAAACCGATAC -> ACAACTGTAACCAAAACCGATACT
ATGAGACCGTGCGATGCGCATCGG -> TGAGACCGTGCGATGCGCATCGGA
GAGGAATAGGCGCTGAGATGCCCG -> AGGAATAGGCGCTGAGATGCCCGA
AGTCAGCATCGAATTAATTGTGCC -> GTCAGCATCGAATTAATTGTGCCG
GGCCTAGACGTGGTAGATTCATGA -> GCCTAGACGTGGTAGATTCATGAC
CTATTGGCGCCAAGAGCTTTCATC -> TATTGGCGCCAAGAGCTTTCATCT
CACCTTAATTAATGCACAGTCTGA -> ACCTTAATTAATGCACAGTCTGAG
CAGTGCAAGGGCACACACGTTTTA -> AGTGCAAGGGCACACACGTTTTAC
AATAAACTGCGGTCAACCATCCCC -> ATAAACTGCGGTCAACCATCCCCC
TACTATCAAATTCCGATCTCTCAC -> ACTATCAAATTCCGATCTCTCACT
TACCAAGTTGCTCAACGCGGTCTT -> ACCAAGTTGCTCAACGCGGTCTTT
AGGCCTCTTGAAAATTAAAGGGTT -> GGCCTCTTGAAAATTAAAGGGTTC
AAATGAAAGGGATCTGAGACGCAG -> AATGAAAGGGATCTGAGACGCAGC
GCTTTTGGATATACAGATTTGTGA -> CTTTTGGATATACAGATTTGTGAG
GAGGGGGCTCTTGGGAAGTTAGAG -> AGGGGGCTCTTGGGAAGTTAGAGA
TAAACTGCGAAATAAACTGCGGTC -> AAACTGCGAAATAAACTGCGGTCA
TCTGACCGGATAATAACTTCACCC -> CTGACCGGATAATAACTTCACCCT
TCCGGACAACTGTAACCAAAACCG -> CCGGACAACTGTAACCAAAACCGA
CCCTCCCAAAAGTCTTAGACAGAG -> CCTCCCAAAAGTCTTAGACAGAGT
AAACTGCGGTCAACCATCCCCCTA -> AACTGCGGTCAACCATCCCCCTAT
GTTTGCTTCTCAGGTACGCTATAT -> TTTGCTTCTCAGGTACGCTATATT
AGAGTAGCAACGTTTGGCTCTATT -> GAGTAGCAACGTTTGGCTCTATTG
CTCTTTGCCGGCGCCGCCCGGGCC -> TCTTTGCCGGCGCCGCCCGGGCCC
GGTCATCAAGAAAGGCCCAGTGCA -> GTCATCAAGAAAGGCCCAGTGCAA
ACCTTCTCTTGTTTGGCTCTAGAC -> CCTTCTCTTGTTTGGCTCTAGACG
CCCCATGCCCTCGAGTGGAGGGGG -> CCCATGCCCTCGAGTGGAGGGGGC
AATGTCCATACATGCATTAAACTA -> ATGTCCATACATGCATTAAACTAA
ATAGTGAGGTACGAAAGTGCTAGC -> TAGTGAGGTACGAAAGTGCTAGCG
TCAACGCGGTCTTTCTAAAATTCG -> CAACGCGGTCTTTCTAAAATTCGT
GGCGTGGGAACGTTGTCTATTGGC -> GCGTGGGAACGTTGTCTATTGGCA
GCGCAGAATCCTGACGGCCCCCCA -> CGCAGAATCCTGACGGCCCCCCAA
ACTTACGAGGAACTATACGGGCCA -> CTTACGAGGAACTATACGGGCCAA
ATGCCCCATGCCCTCGAGTGGAGG -> TGCCCCATGCCCTCGAGTGGAGGG
TTTGTTATCCGGATTGATCTCGCC -> TTGTTATCCGGATTGATCTCGCCG
GGCTCTCACTGTCCAATGTCATCT -> GCTCTCACTGTCCAATGTCATCTC
TGACGGCCCCCCAACTCCGGGTCC -> GACGGCCCCCCAACTCCGGGTCCT
AGAATAATCAATACGGGGGAATTC -> GAATAATCAATACGGGGGAATTCG
GCAAGGGCACACACGTTTTACAGG -> CAAGGGCACACACGTTTTACAGGT
ACCATCCCCCTATCCGGACAACTG -> CCATCCCCCTATCCGGACAACTGT
CTATGAATGTCCATACATGCATTA -> TATGAATGTCCATACATGCATTAA
AAGCAAATCCCTATAGCCCATCAG -> AGCAAATCCCTATAGCCCATCAGA
CTGTTTGGCCTATTGGCGCCAAGA -> TGTTTGGCCTATTGGCGCCAAGAG
GCCGGCGCCGCCCGGGCCCGGCAA -> CCGGCGCCGCCCGGGCCCGGCAAG
CGAGAAGGGAGCATTTTCAGATTG -> GAGAAGGGAGCATTTTCAGATTGC
GAGATTGCCTCTTTGCCGGCGCCG -> AGATTGCCTCTTTGCCGGCGCCGC
GGCCAACGCCGCGTAATCATAGGA -> GCCAACGCCGCGTAATCATAGGAC
ATTACGTATGACACTCACATTGCC -> TTACGTATGACACTCACATTGCCG
AAGGGAGCATTTTCAGATTGCTTG -> AGGGAGCATTTTCAGATTGCTTGT
ATTGCCGGAACTATAGGAATAGAG -> TTGCCGGAACTATAGGAATAGAGT
ATACGCGGCTTTTGGATATACAGA -> TACGCGGCTTTTGGATATACAGAT
TAACTCAATGAGGAATAGGCGCTG -> AACTCAATGAGGAATAGGCGCTGA
CTCTTCTATTTGAGGCAGACTAAG -> TCTTCTATTTGAGGCAGACTAAGC
ATACCGAACATTGCGACAGTGATA -> TACCGAACATTGCGACAGTGATAG
AGCTCTTACGCTTAATCCCACCAT -> GCTCTTACGCTTAATCCCACCATC
TTGGCACCGAATACCGAACATTGC -> TGGCACCGAATACCGAACATTGCG
CACTTGCTACTGCCATGTTTGCTT -> ACTTGCTACTGCCATGTTTGCTTC
GAAAGGGATCTGAGACGCAGCAAT -> AAAGGGATCTGAGACGCAGCAATG
GAATTCGTCAAAAGAAAAAGGGAA -> AATTCGTCAAAAGAAAAAGGGAAA
GGGCCCGGCAAGGCCTCTTGAAAA -> GGCCCGGCAAGGCCTCTTGAAAAT
GCAGACTAAGCCCGGGTTACCAAG -> CAGACTAAGCCCGGGTTACCAAGT
CCATCAGAACGAGACGAGGATAGT -> CATCAGAACGAGACGAGGATAGTG
GCTAAGCCCTCCCCCTGAGGTTGA -> CTAAGCCCTCCCCCTGAGGTTGAA
GAAATATAGTCGACGCTACTACGG -> AAATATAGTCGACGCTACTACGGT
AGCGCTGCTTCCCTCCGTCCATAG -> GCGCTGCTTCCCTCCGTCCATAGT
TAACCAAAACCGATACTATCAAAT -> AACCAAAACCGATACTATCAAATT
CTAGTAAACTGCGAAATAAACTGC -> TAGTAAACTGCGAAATAAACTGCG
CGAGCGACAGCGAAGCAGTTAATA -> GAGCGACAGCGAAGCAGTTAATAT
TAATTGTGCCGAGCGACAGCGAAG -> AATTGTGCCGAGCGACAGCGAAGC
GAGACGAGGATAGTGCTTTATCTG -> AGACGAGGATAGTGCTTTATCTGT
CTCAGGTACGCTATATTTTGCAAA -> TCAGGTACGCTATATTTTGCAAAC
GGTCAGCCGACAATGCCCCATGCC -> GTCAGCCGACAATGCCCCATGCCC
TACTAAAGAACCAGGTCAGCCGAC -> ACTAAAGAACCAGGTCAGCCGACA
ACGAGGAACTATACGGGCCAACGC -> CGAGGAACTATACGGGCCAACGCC
GGTCTACATGTCCGGGGAGATTGC -> GTCTACATGTCCGGGGAGATTGCC
GTGAGACAGTGGCCTATAACGCAC -> TGAGACAGTGGCCTATAACGCACG
AGGGCACACACGTTTTACAGGTCG -> GGGCACACACGTTTTACAGGTCGA
GGGGAGATTGCCTCTTTGCCGGCG -> GGGAGATTGCCTCTTTGCCGGCGC
ATGACCATTTCGTTGTATGAGACC -> TGACCATTTCGTTGTATGAGACCG
GCAAATCCCTATAGCCCATCAGAA -> CAAATCCCTATAGCCCATCAGAAC
GTTGCTCAACGCGGTCTTTCTAAA -> TTGCTCAACGCGGTCTTTCTAAAA
CCTTCTCTTGTTTGGCTCTAGACG -> CTTCTCTTGTTTGGCTCTAGACGG
TCATGCCCTGGTGGCAGCTTTGAG -> CATGCCCTGGTGGCAGCTTTGAGC
AAGGGTTCACGCCGTGGACACTTG -> AGGGTTCACGCCGTGGACACTTGC
CTTCTCAGGTACGCTATATTTTGC -> TTCTCAGGTACGCTATATTTTGCA
TCGTCTTCGGGCCTTTCGGTCTAC -> CGTCTTCGGGCCTTTCGGTCTACA
AGGTCAGCCGACAATGCCCCATGC -> GGTCAGCCGACAATGCCCCATGCC
TCAATGAGGAATAGGCGCTGAGAT -> CAATGAGGAATAGGCGCTGAGATG
TTAATATATTCGGGCGTGGGAACG -> TAATATATTCGGGCGTGGGAACGT
AGAACGAGACGAGGATAGTGCTTT -> GAACGAGACGAGGATAGTGCTTTA
GCCTCTTGAAAATTAAAGGGTTCA -> CCTCTTGAAAATTAAAGGGTTCAC
TGACTCCGAAATTTGTTATCCGGA -> GACTCCGAAATTTGTTATCCGGAT
CCTACCTATGCCGGTAATTTCTCG -> CTACCTATGCCGGTAATTTCTCGT
ATGAAAGGGATCTGAGACGCAGCA -> TGAAAGGGATCTGAGACGCAGCAA
CGCATCGGAGTCAGCATCGAATTA -> GCATCGGAGTCAGCATCGAATTAA
GGTAACTTACGAGGAACTATACGG -> GTAACTTACGAGGAACTATACGGG
AGAATCCTGACGGCCCCCCAACTC -> GAATCCTGACGGCCCCCCAACTCC
TCTCAGGTACGCTATATTTTGCAA -> CTCAGGTACGCTATATTTTGCAAA
AATCATAGGACGTTGTAAATCACT -> ATCATAGGACGTTGTAAATCACTG
CCGAAATTTGTTATCCGGATTGAT -> CGAAATTTGTTATCCGGATTGATC
GAGTCAGAGAATTACGTATGACAC -> AGTCAGAGAATTACGTATGACACT
CGAAGCAGTTAATATATTCGGGCG -> GAAGCAGTTAATATATTCGGGCGT
ATACTATCAAATTCCGATCTCTCA -> TACTATCAAATTCCGATCTCTCAC
ACTCCGGGTCCTGCTAGGGATCAG -> CTCCGGGTCCTGCTAGGGATCAGA
TGTGGCTCTTCTATTTGAGGCAGA -> GTGGCTCTTCTATTTGAGGCAGAC
CGGAACTATAGGAATAGAGTTAAT -> GGAACTATAGGAATAGAGTTAATC
GCCGGCATACGTCCTGTGAGACAG -> CCGGCATACGTCCTGTGAGACAGT
CGCTTAATCCCACCATCGTTATAA -> GCTTAATCCCACCATCGTTATAAA
GTCTATTGGCACCGAATACCGAAC -> TCTATTGGCACCGAATACCGAACA
AGACGTTCATGCCCTGGTGGCAGC -> GACGTTCATGCCCTGGTGGCAGCT
CGTGCGATGCGCATCGGAGTCAGC -> GTGCGATGCGCATCGGAGTCAGCA
GCTCTTCTATTTGAGGCAGACTAA -> CTCTTCTATTTGAGGCAGACTAAG
CTTGACGCGAGCTGTACTGTGCCG -> TTGACGCGAGCTGTACTGTGCCGC
CTCAGGTAACTTACGAGGAACTAT -> TCAGGTAACTTACGAGGAACTATA
ACCGGATAATAACTTCACCCTAGG -> CCGGATAATAACTTCACCCTAGGG
CGGGCCCGGCAAGGCCTCTTGAAA -> GGGCCCGGCAAGGCCTCTTGAAAA
GGCTAGTAAACTGCGAAATAAACT -> GCTAGTAAACTGCGAAATAAACTG
TTTCAGATTGCTTGTTTCACTACC -> TTCAGATTGCTTGTTTCACTACCC
AAAGTTTGGAGTCAGAGAATTACG -> AAGTTTGGAGTCAGAGAATTACGT
TCGATACGCGGCTTTTGGATATAC -> CGATACGCGGCTTTTGGATATACA
TATGACACTCACATTGCCGGAACT -> ATGACACTCACATTGCCGGAACTA
ATATTCGGGCGTGGGAACGTTGTC -> TATTCGGGCGTGGGAACGTTGTCT
AATACGGGGGAATTCGTCAAAAGA -> ATACGGGGGAATTCGTCAAAAGAA
ATAGTGCTTTATCTGTTAGGTACA -> TAGTGCTTTATCTGTTAGGTACAC
GGTACGCTATATTTTGCAAACACA -> GTACGCTATATTTTGCAAACACAA
AACTTACGAGGAACTATACGGGCC -> ACTTACGAGGAACTATACGGGCCA
CTGCCATGTTTGCTTCTCAGGTAC -> TGCCATGTTTGCTTCTCAGGTACG
ATGTCATCTCTGACCGGATAATAA -> TGTCATCTCTGACCGGATAATAAC
AAGGGCACACACGTTTTACAGGTC -> AGGGCACACACGTTTTACAGGTCG
GTGGGAACGTTGTCTATTGGCACC -> TGGGAACGTTGTCTATTGGCACCG
GAGAATTACGTATGACACTCACAT -> AGAATTACGTATGACACTCACATT
AGGGAGCATTTTCAGATTGCTTGT -> GGGAGCATTTTCAGATTGCTTGTT
CGCTAAGCCCTCCCCCTGAGGTTG -> GCTAAGCCCTCCCCCTGAGGTTGA
GAGCTTTCATCTGAGTCAGCGTGT -> AGCTTTCATCTGAGTCAGCGTGTC
TCTTACGCTTAATCCCACCATCGT -> CTTACGCTTAATCCCACCATCGTT
CGCTGAGATGCCCGAGTGACGGGC -> GCTGAGATGCCCGAGTGACGGGCT
GGTTCACGCCGTGGACACTTGCTA -> GTTCACGCCGTGGACACTTGCTAC
TTGAAAATTAAAGGGTTCACGCCG -> TGAAAATTAAAGGGTTCACGCCGT
GGCACACACGTTTTACAGGTCGAT -> GCACACACGTTTTACAGGTCGATA
TAGGTACACCTTCTCTTGTTTGGC -> AGGTACACCTTCTCTTGTTTGGCT
ACCGAACATTGCGACAGTGATAGT -> CCGAACATTGCGACAGTGATAGTA
TTGGCCTATTGGCGCCAAGAGCTT -> TGGCCTATTGGCGCCAAGAGCTTT
CGCAGAATCCTGACGGCCCCCCAA -> GCAGAATCCTGACGGCCCCCCAAC
GTTGTATGAGACCGTGCGATGCGC -> TTGTATGAGACCGTGCGATGCGCA
GAAGGGAGCATTTTCAGATTGCTT -> AAGGGAGCATTTTCAGATTGCTTG
CCTATAGCCCATCAGAACGAGACG -> CTATAGCCCATCAGAACGAGACGA
CCGGGCCCGGCAAGGCCTCTTGAA -> CGGGCCCGGCAAGGCCTCTTGAAA
TGGTAACTGTTTGGCCTATTGGCG -> GGTAACTGTTTGGCCTATTGGCGC
GGTACTCTTAGCACCTTGACGCGA -> GTACTCTTAGCACCTTGACGCGAG
GGGCTAGTAAACTGCGAAATAAAC -> GGCTAGTAAACTGCGAAATAAACT
TTGCTACTGCCATGTTTGCTTCTC -> TGCTACTGCCATGTTTGCTTCTCA
CACTCACATTGCCGGAACTATAGG -> ACTCACATTGCCGGAACTATAGGA
ATAAACTGCGGTCAACCATCCCCC -> TAAACTGCGGTCAACCATCCCCCT
TCACCCTAGGGTCGACCTCTGGGC -> CACCCTAGGGTCGACCTCTGGGCG
AGAAATATAGTCGACGCTACTACG -> GAAATATAGTCGACGCTACTACGG
ACGGGCCAACGCCGCGTAATCATA -> CGGGCCAACGCCGCGTAATCATAG
CAAAGCAAATCCCTATAGCCCATC -> AAAGCAAATCCCTATAGCCCATCA
TTAAATCCAGAACCCTGAATAACA -> TAAATCCAGAACCCTGAATAACAG
TCAGGTACGCTATATTTTGCAAAC -> CAGGTACGCTATATTTTGCAAACA
TTCTCAGGTACGCTATATTTTGCA -> TCTCAGGTACGCTATATTTTGCAA
CTAGTAGTCCCTCGCACAGGTACT -> TAGTAGTCCCTCGCACAGGTACTC
CCCTCCCCCTGAGGTTGAAAAATT -> CCTCCCCCTGAGGTTGAAAAATTG
TTTTACAGGTCGATACGCGGCTTT -> TTTACAGGTCGATACGCGGCTTTT
TCGTTGCACCAGACGTTCATGCCC -> CGTTGCACCAGACGTTCATGCCCT
CATCGGAGTCAGCATCGAATTAAT -> ATCGGAGTCAGCATCGAATTAATT
TCCTGTGAGACAGTGGCCTATAAC -> CCTGTGAGACAGTGGCCTATAACG
CTGTGAGACAGTGGCCTATAACGC -> TGTGAGACAGTGGCCTATAACGCA
ATCTGAGACGCAGCAATGTGGCTC -> TCTGAGACGCAGCAATGTGGCTCT
AAAAGAAAAAGGGAAATAACTATA -> AAAGAAAAAGGGAAATAACTATAG
GTACACCTTCTCTTGTTTGGCTCT -> TACACCTTCTCTTGTTTGGCTCTA
TACATGCATTAAACTAACTCAATG -> ACATGCATTAAACTAACTCAATGA
GCTCGAAACTAAGTACTGGTAACT -> CTCGAAACTAAGTACTGGTAACTG
GCATTTTCAGATTGCTTGTTTCAC -> CATTTTCAGATTGCTTGTTTCACT
AACCGATACTATCAAATTCCGATC -> ACCGATACTATCAAATTCCGATCT
CTTCCCTCCGTCCATAGTCTGACA -> TTCCCTCCGTCCATAGTCTGACAG
GGTACGAAAGTGCTAGCGATAGGT -> GTACGAAAGTGCTAGCGATAGGTC
TGTATGAGACCGTGCGATGCGCAT -> GTATGAGACCGTGCGATGCGCATC
TGCGATGCGCATCGGAGTCAGCAT -> GCGATGCGCATCGGAGTCAGCATC
ATACGTGACTCCGAAATTTGTTAT -> TACGTGACTCCGAAATTTGTTATC
TAGCCCATCAGAACGAGACGAGGA -> AGCCCATCAGAACGAGACGAGGAT
GATAGTAAACCTCGCGTTGTCTGC -> ATAGTAAACCTCGCGTTGTCTGCT
GCGAAATAAACTGCGGTCAACCAT -> CGAAATAAACTGCGGTCAACCATC
CATTTTCAGATTGCTTGTTTCACT -> ATTTTCAGATTGCTTGTTTCACTA
CCGGAACTATAGGAATAGAGTTAA -> CGGAACTATAGGAATAGAGTTAAT
AAACTAACTCAATGAGGAATAGGC -> AACTAACTCAATGAGGAATAGGCG
AGGTTGAAAAATTGCTCGAAACTA -> GGTTGAAAAATTGCTCGAAACTAA
TTGTCTATTGGCACCGAATACCGA -> TGTCTATTGGCACCGAATACCGAA
GCTCTCACTGTCCAATGTCATCTC -> CTCTCACTGTCCAATGTCATCTCT
TTGGCTCTATTGTCTGTTAAGGGG -> TGGCTCTATTGTCTGTTAAGGGGA
GACGTGGTAGATTCATGACCATTT -> ACGTGGTAGATTCATGACCATTTC
TTTGAGGCAGACTAAGCCCGGGTT -> TTGAGGCAGACTAAGCCCGGGTTA
TGATCTCGCCGGTTCGAGAAGGGA -> GATCTCGCCGGTTCGAGAAGGGAG
ACGAAAGTGCTAGCGATAGGTCAT -> CGAAAGTGCTAGCGATAGGTCATC
GCCCTGGTGGCAGCTTTGAGCGCA -> CCCTGGTGGCAGCTTTGAGCGCAC
CCGTCCATAGTCTGACAGGTGGCT -> CGTCCATAGTCTGACAGGTGGCTC
GGGAAGTTAGAGATGGCTCTCACT -> GGAAGTTAGAGATGGCTCTCACTG
TTCTCGTGGCCTAGACGTGGTAGA -> TCTCGTGGCCTAGACGTGGTAGAT
ACAGAAATATAGTCGACGCTACTA -> CAGAAATATAGTCGACGCTACTAC
CTCGTGGCCTAGACGTGGTAGATT -> TCGTGGCCTAGACGTGGTAGATTC
TCTTTCTAAAATTCGTCTTCGGGC -> CTTTCTAAAATTCGTCTTCGGGCC
TGCTTTATCTGTTAGGTACACCTT -> GCTTTATCTGTTAGGTACACCTTC
ACTCACCTTAATTAATGCACAGTC -> CTCACCTTAATTAATGCACAGTCT
GACGTTGTAAATCACTGCAGCGCT -> ACGTTGTAAATCACTGCAGCGCTG
AGGAATAGAGTTAATCTATGAATG -> GGAATAGAGTTAATCTATGAATGT
ACGCCGTGGACACTTGCTACTGCC -> CGCCGTGGACACTTGCTACTGCCA
GTACTGGTAACTGTTTGGCCTATT -> TACTGGTAACTGTTTGGCCTATTG
TTTGAGCGCACAGAAATATAGTCG -> TTGAGCGCACAGAAATATAGTCGA
TGCAGCGCTGCTACTCACCTTAAT -> GCAGCGCTGCTACTCACCTTAATT
ATCTCGCCGGTTCGAGAAGGGAGC -> TCTCGCCGGTTCGAGAAGGGAGCA
GCCGACAATGCCCCATGCCCTCGA -> CCGACAATGCCCCATGCCCTCGAG
CAATACGGGGGAATTCGTCAAAAG -> AATACGGGGGAATTCGTCAAAAGA
GGCTTTTGGATATACAGATTTGTG -> GCTTTTGGATATACAGATTTGTGA
CGAAATAAACTGCGGTCAACCATC -> GAAATAAACTGCGGTCAACCATCC
GTACTGTGCCGCCGGCATACGTCC -> TACTGTGCCGCCGGCATACGTCCT
GTTATCCGGATTGATCTCGCCGGT -> TTATCCGGATTGATCTCGCCGGTT
TACGGTAGCTCACCATTGAAGTAG -> ACGGTAGCTCACCATTGAAGTAGA
GTCGTTGCACCAGACGTTCATGCC -> TCGTTGCACCAGACGTTCATGCCC
CCTGACGGCCCCCCAACTCCGGGT -> CTGACGGCCCCCCAACTCCGGGTC
GTGAGCACTAGTAGTCCCTCGCAC -> TGAGCACTAGTAGTCCCTCGCACA
CCCTCCGTCCATAGTCTGACAGGT -> CCTCCGTCCATAGTCTGACAGGTG
TCTTTGCCGGCGCCGCCCGGGCCC -> CTTTGCCGGCGCCGCCCGGGCCCG
TGAGTCAGCGTGTCTTTTTGATAA -> GAGTCAGCGTGTCTTTTTGATAAG
TTGCTTCTCAGGTACGCTATATTT -> TGCTTCTCAGGTACGCTATATTTT
GCTGCTTCCCTCCGTCCATAGTCT -> CTGCTTCCCTCCGTCCATAGTCTG
CTCACCTTAATTAATGCACAGTCT -> TCACCTTAATTAATGCACAGTCTG
TGAGGTTGAAAAATTGCTCGAAAC -> GAGGTTGAAAAATTGCTCGAAACT
CTATTTGAGGCAGACTAAGCCCGG -> TATTTGAGGCAGACTAAGCCCGGG
CGCTGCTACTCACCTTAATTAATG -> GCTGCTACTCACCTTAATTAATGC
TGAGCGCACAGAAATATAGTCGAC -> GAGCGCACAGAAATATAGTCGACG
GGCTCTTCTATTTGAGGCAGACTA -> GCTCTTCTATTTGAGGCAGACTAA
GGAACTATAGGAATAGAGTTAATC -> GAACTATAGGAATAGAGTTAATCT
TAAACTAACTCAATGAGGAATAGG -> AAACTAACTCAATGAGGAATAGGC
CTATTGTCTGTTAAGGGGAGCTCG -> TATTGTCTGTTAAGGGGAGCTCGC
TTATCCGGATTGATCTCGCCGGTT -> TATCCGGATTGATCTCGCCGGTTC
AGGGTTCACGCCGTGGACACTTGC -> GGGTTCACGCCGTGGACACTTGCT
GACAGAGTAGCAACGTTTGGCTCT -> ACAGAGTAGCAACGTTTGGCTCTA
GATAATAACTTCACCCTAGGGTCG -> ATAATAACTTCACCCTAGGGTCGA
CCTCTGGGCGCCCCTCCCAAAAGT -> CTCTGGGCGCCCCTCCCAAAAGTC
ACACTCACATTGCCGGAACTATAG -> CACTCACATTGCCGGAACTATAGG
CACCTTCTCTTGTTTGGCTCTAGA -> ACCTTCTCTTGTTTGGCTCTAGAC
TACCCTCTTAAGCTACTAAAGAAC -> ACCCTCTTAAGCTACTAAAGAACC
CCCGAGTGACGGGCTAGTAAACTG -> CCGAGTGACGGGCTAGTAAACTGC
AGAAAAAGGGAAATAACTATAGTG -> GAAAAAGGGAAATAACTATAGTGA
TCATAGGACGTTGTAAATCACTGC -> CATAGGACGTTGTAAATCACTGCA
TATCCGGATTGATCTCGCCGGTTC -> ATCCGGATTGATCTCGCCGGTTCG
ACCAGACGTTCATGCCCTGGTGGC -> CCAGACGTTCATGCCCTGGTGGCA
AATGAGGAATAGGCGCTGAGATGC -> ATGAGGAATAGGCGCTGAGATGCC
AGTGCAAGGGCACACACGTTTTAC -> GTGCAAGGGCACACACGTTTTACA
CAAAAGAAAAAGGGAAATAACTAT -> AAAAGAAAAAGGGAAATAACTATA
CGCACAGAAATATAGTCGACGCTA -> GCACAGAAATATAGTCGACGCTAC
CTGACCGGATAATAACTTCACCCT -> TGACCGGATAATAACTTCACCCTA
GTTTTACAGGTCGATACGCGGCTT -> TTTTACAGGTCGATACGCGGCTTT
GATGGGATCTCAAAGCAAATCCCT -> ATGGGATCTCAAAGCAAATCCCTA
TTAATTAATGCACAGTCTGAGAAA -> TAATTAATGCACAGTCTGAGAAAG
GGTCTTTCTAAAATTCGTCTTCGG -> GTCTTTCTAAAATTCGTCTTCGGG
GTGGCTCTTCTATTTGAGGCAGAC -> TGGCTCTTCTATTTGAGGCAGACT
GTTAAGGGGAGCTCGCTAAGCCCT -> TTAAGGGGAGCTCGCTAAGCCCTC
GTTCACGCCGTGGACACTTGCTAC -> TTCACGCCGTGGACACTTGCTACT
ATCCTGACGGCCCCCCAACTCCGG -> TCCTGACGGCCCCCCAACTCCGGG
TGAGGAATAGGCGCTGAGATGCCC -> GAGGAATAGGCGCTGAGATGCCCG
TTAAGCTACTAAAGAACCAGGTCA -> TAAGCTACTAAAGAACCAGGTCAG
TATTGGCGCCAAGAGCTTTCATCT -> ATTGGCGCCAAGAGCTTTCATCTG
AGCCGACAATGCCCCATGCCCTCG -> GCCGACAATGCCCCATGCCCTCGA
AAAATTGCTCGAAACTAAGTACTG -> AAATTGCTCGAAACTAAGTACTGG
TGAAAGGGATCTGAGACGCAGCAA -> GAAAGGGATCTGAGACGCAGCAAT
CCGAGTGACGGGCTAGTAAACTGC -> CGAGTGACGGGCTAGTAAACTGCG
TCGCCGGTTCGAGAAGGGAGCATT -> CGCCGGTTCGAGAAGGGAGCATTT
TGGATATACAGATTTGTGAGCACT -> GGATATACAGATTTGTGAGCACTA
CCGACAATGCCCCATGCCCTCGAG -> CGACAATGCCCCATGCCCTCGAGT
ACGGCCCCCCAACTCCGGGTCCTG -> CGGCCCCCCAACTCCGGGTCCTGC
ACAGATTTGTGAGCACTAGTAGTC -> CAGATTTGTGAGCACTAGTAGTCC
TATGAGACCGTGCGATGCGCATCG -> ATGAGACCGTGCGATGCGCATCGG
ATGCCCTCGAGTGGAGGGGGCTCT -> TGCCCTCGAGTGGAGGGGGCTCTT
AAAGAAAAAGGGAAATAACTATAG -> AAGAAAAAGGGAAATAACTATAGT
AAGTGCTAGCGATAGGTCATCAAG -> AGTGCTAGCGATAGGTCATCAAGA
TTAATGCACAGTCTGAGAAAGTTT -> TAATGCACAGTCTGAGAAAGTTTG
CGCCGCGTAATCATAGGACGTTGT -> GCCGCGTAATCATAGGACGTTGTA
TCTAAAATTCGTCTTCGGGCCTTT -> CTAAAATTCGTCTTCGGGCCTTTC
GCTACTACGGTAGCTCACCATTGA -> CTACTACGGTAGCTCACCATTGAA
CTGGTAACTGTTTGGCCTATTGGC -> TGGTAACTGTTTGGCCTATTGGCG
GGTCGACCTCTGGGCGCCCCTCCC -> GTCGACCTCTGGGCGCCCCTCCCA
CCTGAATAACAGGGCACTGCGCAG -> CTGAATAACAGGGCACTGCGCAGA
TAAGCCCTCCCCCTGAGGTTGAAA -> AAGCCCTCCCCCTGAGGTTGAAAA
ATACAGATTTGTGAGCACTAGTAG -> TACAGATTTGTGAGCACTAGTAGT
CCCTATCCGGACAACTGTAACCAA -> CCTATCCGGACAACTGTAACCAAA
GTCAGCGTGTCTTTTTGATAAGTC -> TCAGCGTGTCTTTTTGATAAGTCG
CATCAAGAAAGGCCCAGTGCAAGG -> ATCAAGAAAGGCCCAGTGCAAGGG
CCTCCGTCCATAGTCTGACAGGTG -> CTCCGTCCATAGTCTGACAGGTGG
TCAAGAAAGGCCCAGTGCAAGGGC -> CAAGAAAGGCCCAGTGCAAGGGCA
TTCAGATTGCTTGTTTCACTACCC -> TCAGATTGCTTGTTTCACTACCCT
TCCATACATGCATTAAACTAACTC -> CCATACATGCATTAAACTAACTCA
TAAACTGCGGTCAACCATCCCCCT -> AAACTGCGGTCAACCATCCCCCTA
ATTGCTTGTTTCACTACCCTCTTA -> TTGCTTGTTTCACTACCCTCTTAA
TTCATGCCCTGGTGGCAGCTTTGA -> TCATGCCCTGGTGGCAGCTTTGAG
GAATGTCCATACATGCATTAAACT -> AATGTCCATACATGCATTAAACTA
TCGCGTTGTCTGCTAGTGAGCTCT -> CGCGTTGTCTGCTAGTGAGCTCTT
AAGCTACTAAAGAACCAGGTCAGC -> AGCTACTAAAGAACCAGGTCAGCC
TTTCTAAAATTCGTCTTCGGGCCT -> TTCTAAAATTCGTCTTCGGGCCTT
CTGCAGCGCTGCTACTCACCTTAA -> TGCAGCGCTGCTACTCACCTTAAT
CAGAAATATAGTCGACGCTACTAC -> AGAAATATAGTCGACGCTACTACG
AGCGACAGCGAAGCAGTTAATATA -> GCGACAGCGAAGCAGTTAATATAT
ACGTGGTAGATTCATGACCATTTC -> CGTGGTAGATTCATGACCATTTCG
CATTGCCGGAACTATAGGAATAGA -> ATTGCCGGAACTATAGGAATAGAG
GAAAATTAAAGGGTTCACGCCGTG -> AAAATTAAAGGGTTCACGCCGTGG
AATTAAAGGGTTCACGCCGTGGAC -> ATTAAAGGGTTCACGCCGTGGACA
AATTTCTCGTGGCCTAGACGTGGT -> ATTTCTCGTGGCCTAGACGTGGTA
GCAACGTTTGGCTCTATTGTCTGT -> CAACGTTTGGCTCTATTGTCTGTT
TGCTCAACGCGGTCTTTCTAAAAT -> GCTCAACGCGGTCTTTCTAAAATT
GACGATGGGATCTCAAAGCAAATC -> ACGATGGGATCTCAAAGCAAATCC
ACAGGTACTCTTAGCACCTTGACG -> CAGGTACTCTTAGCACCTTGACGC
AGTGACGGGCTAGTAAACTGCGAA -> GTGACGGGCTAGTAAACTGCGAAA
GATTGCTTGTTTCACTACCCTCTT -> ATTGCTTGTTTCACTACCCTCTTA
TGAATGTCCATACATGCATTAAAC -> GAATGTCCATACATGCATTAAACT
AGTGCTTTATCTGTTAGGTACACC -> GTGCTTTATCTGTTAGGTACACCT
TAGTGAGCTCTTACGCTTAATCCC -> AGTGAGCTCTTACGCTTAATCCCA
TTGAGCGCACAGAAATATAGTCGA -> TGAGCGCACAGAAATATAGTCGAC
GGGAATTCGTCAAAAGAAAAAGGG -> GGAATTCGTCAAAAGAAAAAGGGA
GATCTCTCACTTGATTAAATCCAG -> ATCTCTCACTTGATTAAATCCAGA
CTGGGCGCCCCTCCCAAAAGTCTT -> TGGGCGCCCCTCCCAAAAGTCTTA
GTAGCTCACCATTGAAGTAGAATA -> TAGCTCACCATTGAAGTAGAATAA
AGATGCCCGAGTGACGGGCTAGTA -> GATGCCCGAGTGACGGGCTAGTAA
TAACTTACGAGGAACTATACGGGC -> AACTTACGAGGAACTATACGGGCC
TATTGTCTGTTAAGGGGAGCTCGC -> ATTGTCTGTTAAGGGGAGCTCGCT
TGTTTCACTACCCTCTTAAGCTAC -> GTTTCACTACCCTCTTAAGCTACT
AGCGTGTCTTTTTGATAAGTCGTT -> GCGTGTCTTTTTGATAAGTCGTTG
CTAGGGATCAGACGATGGGATCTC -> TAGGGATCAGACGATGGGATCTCA
CGAGCTGTACTGTGCCGCCGGCAT -> GAGCTGTACTGTGCCGCCGGCATA
GCTAGTAAACTGCGAAATAAACTG -> CTAGTAAACTGCGAAATAAACTGC
TGCCCTCGAGTGGAGGGGGCTCTT -> GCCCTCGAGTGGAGGGGGCTCTTG
TCAAAAGAAAAAGGGAAATAACTA -> CAAAAGAAAAAGGGAAATAACTAT
AACTATACGGGCCAACGCCGCGTA -> ACTATACGGGCCAACGCCGCGTAA
AAACACAATGAGCGCTGCTTCCCT -> AACACAATGAGCGCTGCTTCCCTC
TAACTATAGTGAGGTACGAAAGTG -> AACTATAGTGAGGTACGAAAGTGC
CGGTAATTTCTCGTGGCCTAGACG -> GGTAATTTCTCGTGGCCTAGACGT
AGATGGCTCTCACTGTCCAATGTC -> GATGGCTCTCACTGTCCAATGTCA
TTATCTGTTAGGTACACCTTCTCT -> TATCTGTTAGGTACACCTTCTCTT
TCGTCAAAAGAAAAAGGGAAATAA -> CGTCAAAAGAAAAAGGGAAATAAC
TGCCCTGGTGGCAGCTTTGAGCGC -> GCCCTGGTGGCAGCTTTGAGCGCA
ATGCATTAAACTAACTCAATGAGG -> TGCATTAAACTAACTCAATGAGGA
CCGGCATACGTCCTGTGAGACAGT -> CGGCATACGTCCTGTGAGACAGTG
ATCATAGGACGTTGTAAATCACTG -> TCATAGGACGTTGTAAATCACTGC
CGTATGACACTCACATTGCCGGAA -> GTATGACACTCACATTGCCGGAAC
CTATAGTGAGGTACGAAAGTGCTA -> TATAGTGAGGTACGAAAGTGCTAG
ATTAATGCACAGTCTGAGAAAGTT -> TTAATGCACAGTCTGAGAAAGTTT
ACTAACTCAATGAGGAATAGGCGC -> CTAACTCAATGAGGAATAGGCGCT
GGTTACCAAGTTGCTCAACGCGGT -> GTTACCAAGTTGCTCAACGCGGTC
TAGGCGCTGAGATGCCCGAGTGAC -> AGGCGCTGAGATGCCCGAGTGACG
AAACTAAGTACTGGTAACTGTTTG -> AACTAAGTACTGGTAACTGTTTGG
GCTTTCATCTGAGTCAGCGTGTCT -> CTTTCATCTGAGTCAGCGTGTCTT
CTCACTGTCCAATGTCATCTCTGA -> TCACTGTCCAATGTCATCTCTGAC
GCCTCTTTGCCGGCGCCGCCCGGG -> CCTCTTTGCCGGCGCCGCCCGGGC
CTCTTGAAAATTAAAGGGTTCACG -> TCTTGAAAATTAAAGGGTTCACGC
AGGGTCGACCTCTGGGCGCCCCTC -> GGGTCGACCTCTGGGCGCCCCTCC
GCTACTGCCATGTTTGCTTCTCAG -> CTACTGCCATGTTTGCTTCTCAGG
TGGTAGATTCATGACCATTTCGTT -> GGTAGATTCATGACCATTTCGTTG
TTCGGTCTACATGTCCGGGGAGAT -> TCGGTCTACATGTCCGGGGAGATT
CTACTACGGTAGCTCACCATTGAA -> TACTACGGTAGCTCACCATTGAAG
GGAGCTCGCTAAGCCCTCCCCCTG -> GAGCTCGCTAAGCCCTCCCCCTGA
TTCGTCAAAAGAAAAAGGGAAATA -> TCGTCAAAAGAAAAAGGGAAATAA
CGCGGCTTTTGGATATACAGATTT -> GCGGCTTTTGGATATACAGATTTG
ATTTGTTATCCGGATTGATCTCGC -> TTTGTTATCCGGATTGATCTCGCC
TGCTCGAAACTAAGTACTGGTAAC -> GCTCGAAACTAAGTACTGGTAACT
CATGCCCTCGAGTGGAGGGGGCTC -> ATGCCCTCGAGTGGAGGGGGCTCT
GACGCAGCAATGTGGCTCTTCTAT -> ACGCAGCAATGTGGCTCTTCTATT
TGATAAGTCGTTGCACCAGACGTT -> GATAAGTCGTTGCACCAGACGTTC
GCTTTATCTGTTAGGTACACCTTC -> CTTTATCTGTTAGGTACACCTTCT
CTCGCGTTGTCTGCTAGTGAGCTC -> TCGCGTTGTCTGCTAGTGAGCTCT
TGTCTTTTTGATAAGTCGTTGCAC -> GTCTTTTTGATAAGTCGTTGCACC
CAGACTAAGCCCGGGTTACCAAGT -> AGACTAAGCCCGGGTTACCAAGTT
GAGAAAGTTTGGAGTCAGAGAATT -> AGAAAGTTTGGAGTCAGAGAATTA
AGTGGCCTATAACGCACGGTCCTC -> GTGGCCTATAACGCACGGTCCTCC
CCTAGACGTGGTAGATTCATGACC -> CTAGACGTGGTAGATTCATGACCA
GGTCAACCATCCCCCTATCCGGAC -> GTCAACCATCCCCCTATCCGGACA
CCTATAACGCACGGTCCTCCTACC -> CTATAACGCACGGTCCTCCTACCT
CTCCTACCTATGCCGGTAATTTCT -> TCCTACCTATGCCGGTAATTTCTC
CGATGGGATCTCAAAGCAAATCCC -> GATGGGATCTCAAAGCAAATCCCT
AAGCCCGGGTTACCAAGTTGCTCA -> AGCCCGGGTTACCAAGTTGCTCAA
GGGGAATTCGTCAAAAGAAAAAGG -> GGGAATTCGTCAAAAGAAAAAGGG
GTCGATACGCGGCTTTTGGATATA -> TCGATACGCGGCTTTTGGATATAC
ATTAATTGTGCCGAGCGACAGCGA -> TTAATTGTGCCGAGCGACAGCGAA
CCCGGCAAGGCCTCTTGAAAATTA -> CCGGCAAGGCCTCTTGAAAATTAA
GAGCGCTGCTTCCCTCCGTCCATA -> AGCGCTGCTTCCCTCCGTCCATAG
GCGTTGTCTGCTAGTGAGCTCTTA -> CGTTGTCTGCTAGTGAGCTCTTAC
TCTGACAGGTGGCTCAGGTAACTT -> CTGACAGGTGGCTCAGGTAACTTA
CCTCTTGAAAATTAAAGGGTTCAC -> CTCTTGAAAATTAAAGGGTTCACG
TTAGACAGAGTAGCAACGTTTGGC -> TAGACAGAGTAGCAACGTTTGGCT
TACGGGCCAACGCCGCGTAATCAT -> ACGGGCCAACGCCGCGTAATCATA
ATCTCTCACTTGATTAAATCCAGA -> TCTCTCACTTGATTAAATCCAGAA
GAGTCAGCATCGAATTAATTGTGC -> AGTCAGCATCGAATTAATTGTGCC
CGCACAGGTACTCTTAGCACCTTG -> GCACAGGTACTCTTAGCACCTTGA
CGTTATAAATGAAAGGGATCTGAG -> GTTATAAATGAAAGGGATCTGAGA
TTGTGAGCACTAGTAGTCCCTCGC -> TGTGAGCACTAGTAGTCCCTCGCA
TAGCGATAGGTCATCAAGAAAGGC -> AGCGATAGGTCATCAAGAAAGGCC
TCCCTCCGTCCATAGTCTGACAGG -> CCCTCCGTCCATAGTCTGACAGGT
GTCTTTTTGATAAGTCGTTGCACC -> TCTTTTTGATAAGTCGTTGCACCA
GGAACGTTGTCTATTGGCACCGAA -> GAACGTTGTCTATTGGCACCGAAT
TGCCTCTTTGCCGGCGCCGCCCGG -> GCCTCTTTGCCGGCGCCGCCCGGG
TTCTAAAATTCGTCTTCGGGCCTT -> TCTAAAATTCGTCTTCGGGCCTTT
TCCCCCTGAGGTTGAAAAATTGCT -> CCCCCTGAGGTTGAAAAATTGCTC
AATCACTGCAGCGCTGCTACTCAC -> ATCACTGCAGCGCTGCTACTCACC
CAAATTCCGATCTCTCACTTGATT -> AAATTCCGATCTCTCACTTGATTA
GTCAGAGAATTACGTATGACACTC -> TCAGAGAATTACGTATGACACTCA
GACCATTTCGTTGTATGAGACCGT -> ACCATTTCGTTGTATGAGACCGTG
TAGATTCATGACCATTTCGTTGTA -> AGATTCATGACCATTTCGTTGTAT
GCGAGCTGTACTGTGCCGCCGGCA -> CGAGCTGTACTGTGCCGCCGGCAT
TTAGCACCTTGACGCGAGCTGTAC -> TAGCACCTTGACGCGAGCTGTACT
AGTGGAGGGGGCTCTTGGGAAGTT -> GTGGAGGGGGCTCTTGGGAAGTTA
GAGATGCCCGAGTGACGGGCTAGT -> AGATGCCCGAGTGACGGGCTAGTA
ATAGCCCATCAGAACGAGACGAGG -> TAGCCCATCAGAACGAGACGAGGA
GATTTGTGAGCACTAGTAGTCCCT -> ATTTGTGAGCACTAGTAGTCCCTC
AGGAACTATACGGGCCAACGCCGC -> GGAACTATACGGGCCAACGCCGCG
TAGGACGTTGTAAATCACTGCAGC -> AGGACGTTGTAAATCACTGCAGCG
TCAGACGATGGGATCTCAAAGCAA -> CAGACGATGGGATCTCAAAGCAAA
AATTAATTGTGCCGAGCGACAGCG -> ATTAATTGTGCCGAGCGACAGCGA
CTCGAAACTAAGTACTGGTAACTG -> TCGAAACTAAGTACTGGTAACTGT
GAAAAATTGCTCGAAACTAAGTAC -> AAAAATTGCTCGAAACTAAGTACT
ATTTGAGGCAGACTAAGCCCGGGT -> TTTGAGGCAGACTAAGCCCGGGTT
GAAGTAGAATAATCAATACGGGGG -> AAGTAGAATAATCAATACGGGGGA
AAAAGGGAAATAACTATAGTGAGG -> AAAGGGAAATAACTATAGTGAGGT
CTCTTACGCTTAATCCCACCATCG -> TCTTACGCTTAATCCCACCATCGT
TCTCACTTGATTAAATCCAGAACC -> CTCACTTGATTAAATCCAGAACCC
TTCATGACCATTTCGTTGTATGAG -> TCATGACCATTTCGTTGTATGAGA
TGGCACCGAATACCGAACATTGCG -> GGCACCGAATACCGAACATTGCGA
GGAGCATTTTCAGATTGCTTGTTT -> GAGCATTTTCAGATTGCTTGTTTC
GTGCCGCCGGCATACGTCCTGTGA -> TGCCGCCGGCATACGTCCTGTGAG
GTAATTTCTCGTGGCCTAGACGTG -> TAATTTCTCGTGGCCTAGACGTGG
GAGCTCGCTAAGCCCTCCCCCTGA -> AGCTCGCTAAGCCCTCCCCCTGAG
ATGTCCATACATGCATTAAACTAA -> TGTCCATACATGCATTAAACTAAC
AATACCGAACATTGCGACAGTGAT -> ATACCGAACATTGCGACAGTGATA
TTCACCCTAGGGTCGACCTCTGGG -> TCACCCTAGGGTCGACCTCTGGGC
TTGTCTGCTAGTGAGCTCTTACGC -> TGTCTGCTAGTGAGCTCTTACGCT
AACTGCGAAATAAACTGCGGTCAA -> ACTGCGAAATAAACTGCGGTCAAC
CATTTCGTTGTATGAGACCGTGCG -> ATTTCGTTGTATGAGACCGTGCGA
TCTTCTATTTGAGGCAGACTAAGC -> CTTCTATTTGAGGCAGACTAAGCC
ATGCACAGTCTGAGAAAGTTTGGA -> TGCACAGTCTGAGAAAGTTTGGAG
GCGATGCGCATCGGAGTCAGCATC -> CGATGCGCATCGGAGTCAGCATCG
CCTCCTACCTATGCCGGTAATTTC -> CTCCTACCTATGCCGGTAATTTCT
CTAAAGAACCAGGTCAGCCGACAA -> TAAAGAACCAGGTCAGCCGACAAT
TTTGATAAGTCGTTGCACCAGACG -> TTGATAAGTCGTTGCACCAGACGT
GGTGGCTCAGGTAACTTACGAGGA -> GTGGCTCAGGTAACTTACGAGGAA
TATAACGCACGGTCCTCCTACCTA -> ATAACGCACGGTCCTCCTACCTAT
AGTCAGAGAATTACGTATGACACT -> GTCAGAGAATTACGTATGACACTC
GCCGTGGACACTTGCTACTGCCAT -> CCGTGGACACTTGCTACTGCCATG
GACAGTGATAGTAAACCTCGCGTT -> ACAGTGATAGTAAACCTCGCGTTG
GCGCCAAGAGCTTTCATCTGAGTC -> CGCCAAGAGCTTTCATCTGAGTCA
CGCCGCCCGGGCCCGGCAAGGCCT -> GCCGCCCGGGCCCGGCAAGGCCTC
GAGACCGTGCGATGCGCATCGGAG -> AGACCGTGCGATGCGCATCGGAGT
TAACGCACGGTCCTCCTACCTATG -> AACGCACGGTCCTCCTACCTATGC
TGACGCGAGCTGTACTGTGCCGCC -> GACGCGAGCTGTACTGTGCCGCCG
GGGTTACCAAGTTGCTCAACGCGG -> GGTTACCAAGTTGCTCAACGCGGT
GAGATGGCTCTCACTGTCCAATGT -> AGATGGCTCTCACTGTCCAATGTC
AACTGCGGTCAACCATCCCCCTAT -> ACTGCGGTCAACCATCCCCCTATC
AATGAAAGGGATCTGAGACGCAGC -> ATGAAAGGGATCTGAGACGCAGCA
CGGGGGAATTCGTCAAAAGAAAAA -> GGGGGAATTCGTCAAAAGAAAAAG
TTCACGCCGTGGACACTTGCTACT -> TCACGCCGTGGACACTTGCTACTG
CCGAATACCGAACATTGCGACAGT -> CGAATACCGAACATTGCGACAGTG
CGATCTCTCACTTGATTAAATCCA -> GATCTCTCACTTGATTAAATCCAG
ATAACGCACGGTCCTCCTACCTAT -> TAACGCACGGTCCTCCTACCTATG
GATGCGCATCGGAGTCAGCATCGA -> ATGCGCATCGGAGTCAGCATCGAA
GCTAGCGATAGGTCATCAAGAAAG -> CTAGCGATAGGTCATCAAGAAAGG
CGATACGCGGCTTTTGGATATACA -> GATACGCGGCTTTTGGATATACAG
GGGTTCACGCCGTGGACACTTGCT -> GGTTCACGCCGTGGACACTTGCTA
TCACTGCAGCGCTGCTACTCACCT -> CACTGCAGCGCTGCTACTCACCTT
TGCCGAGCGACAGCGAAGCAGTTA -> GCCGAGCGACAGCGAAGCAGTTAA
AGGGCACTGCGCAGAATCCTGACG -> GGGCACTGCGCAGAATCCTGACGG
CAGAATCCTGACGGCCCCCCAACT -> AGAATCCTGACGGCCCCCCAACTC
CACGGTCCTCCTACCTATGCCGGT -> ACGGTCCTCCTACCTATGCCGGTA
CATTGCGACAGTGATAGTAAACCT -> ATTGCGACAGTGATAGTAAACCTC
CACAGGTACTCTTAGCACCTTGAC -> ACAGGTACTCTTAGCACCTTGACG
AGTCAGCGTGTCTTTTTGATAAGT -> GTCAGCGTGTCTTTTTGATAAGTC
ATCGTTATAAATGAAAGGGATCTG -> TCGTTATAAATGAAAGGGATCTGA
AGCTTTGAGCGCACAGAAATATAG -> GCTTTGAGCGCACAGAAATATAGT
CGATACTATCAAATTCCGATCTCT -> GATACTATCAAATTCCGATCTCTC
GAGCGCACAGAAATATAGTCGACG -> AGCGCACAGAAATATAGTCGACGC
CTACTCACCTTAATTAATGCACAG -> TACTCACCTTAATTAATGCACAGT
ACCTATGCCGGTAATTTCTCGTGG -> CCTATGCCGGTAATTTCTCGTGGC
ACCCTAGGGTCGACCTCTGGGCGC -> CCCTAGGGTCGACCTCTGGGCGCC
CGAGTGACGGGCTAGTAAACTGCG -> GAGTGACGGGCTAGTAAACTGCGA
CTCTCACTGTCCAATGTCATCTCT -> TCTCACTGTCCAATGTCATCTCTG
AAATCACTGCAGCGCTGCTACTCA -> AATCACTGCAGCGCTGCTACTCAC
TCGCACAGGTACTCTTAGCACCTT -> CGCACAGGTACTCTTAGCACCTTG
CTACCTATGCCGGTAATTTCTCGT -> TACCTATGCCGGTAATTTCTCGTG
CGGGCGTGGGAACGTTGTCTATTG -> GGGCGTGGGAACGTTGTCTATTGG
CCAGTGCAAGGGCACACACGTTTT -> CAGTGCAAGGGCACACACGTTTTA
TAATTTCTCGTGGCCTAGACGTGG -> AATTTCTCGTGGCCTAGACGTGGT
CCGATCTCTCACTTGATTAAATCC -> CGATCTCTCACTTGATTAAATCCA
TTTTTGATAAGTCGTTGCACCAGA -> TTTTGATAAGTCGTTGCACCAGAC
CGGTCTACATGTCCGGGGAGATTG -> GGTCTACATGTCCGGGGAGATTGC
TATCAAATTCCGATCTCTCACTTG -> ATCAAATTCCGATCTCTCACTTGA
CTGAGAAAGTTTGGAGTCAGAGAA -> TGAGAAAGTTTGGAGTCAGAGAAT
CTTCTCTTGTTTGGCTCTAGACGG -> TTCTCTTGTTTGGCTCTAGACGGT
TTGAAAAATTGCTCGAAACTAAGT -> TGAAAAATTGCTCGAAACTAAGTA
GGCATACGTCCTGTGAGACAGTGG -> GCATACGTCCTGTGAGACAGTGGC
TGACGGGCTAGTAAACTGCGAAAT -> GACGGGCTAGTAAACTGCGAAATA
GATACTATCAAATTCCGATCTCTC -> ATACTATCAAATTCCGATCTCTCA
ATAAGTCGTTGCACCAGACGTTCA -> TAAGTCGTTGCACCAGACGTTCAT
TCACGCCGTGGACACTTGCTACTG -> CACGCCGTGGACACTTGCTACTGC
TCCTACCTATGCCGGTAATTTCTC -> CCTACCTATGCCGGTAATTTCTCG
GAGGATAGTGCTTTATCTGTTAGG -> AGGATAGTGCTTTATCTGTTAGGT
TGCCGCCGGCATACGTCCTGTGAG -> GCCGCCGGCATACGTCCTGTGAGA
ATATACAGATTTGTGAGCACTAGT -> TATACAGATTTGTGAGCACTAGTA
GGCGCTGAGATGCCCGAGTGACGG -> GCGCTGAGATGCCCGAGTGACGGG
TCTATTGTCTGTTAAGGGGAGCTC -> CTATTGTCTGTTAAGGGGAGCTCG
AATAGGCGCTGAGATGCCCGAGTG -> ATAGGCGCTGAGATGCCCGAGTGA
AGTAGAATAATCAATACGGGGGAA -> GTAGAATAATCAATACGGGGGAAT
CTTTATCTGTTAGGTACACCTTCT -> TTTATCTGTTAGGTACACCTTCTC
GTGCGATGCGCATCGGAGTCAGCA -> TGCGATGCGCATCGGAGTCAGCAT
CCCCAACTCCGGGTCCTGCTAGGG -> CCCAACTCCGGGTCCTGCTAGGGA
TAAGTCGTTGCACCAGACGTTCAT -> AAGTCGTTGCACCAGACGTTCATG
TAACTGTTTGGCCTATTGGCGCCA -> AACTGTTTGGCCTATTGGCGCCAA
GGAATTCGTCAAAAGAAAAAGGGA -> GAATTCGTCAAAAGAAAAAGGGAA
CTTCACCCTAGGGTCGACCTCTGG -> TTCACCCTAGGGTCGACCTCTGGG
TGTTAGGTACACCTTCTCTTGTTT -> GTTAGGTACACCTTCTCTTGTTTG
AAGCCCTCCCCCTGAGGTTGAAAA -> AGCCCTCCCCCTGAGGTTGAAAAA
ATCCGGACAACTGTAACCAAAACC -> TCCGGACAACTGTAACCAAAACCG
CAAAAGTCTTAGACAGAGTAGCAA -> AAAAGTCTTAGACAGAGTAGCAAC
ACGTGACTCCGAAATTTGTTATCC -> CGTGACTCCGAAATTTGTTATCCG
AACTGTTTGGCCTATTGGCGCCAA -> ACTGTTTGGCCTATTGGCGCCAAG
GAGCACTAGTAGTCCCTCGCACAG -> AGCACTAGTAGTCCCTCGCACAGG
ATCGGAGTCAGCATCGAATTAATT -> TCGGAGTCAGCATCGAATTAATTG
ACTCACATTGCCGGAACTATAGGA -> CTCACATTGCCGGAACTATAGGAA
TCCTCCTACCTATGCCGGTAATTT -> CCTCCTACCTATGCCGGTAATTTC
GTCTGAGAAAGTTTGGAGTCAGAG -> TCTGAGAAAGTTTGGAGTCAGAGA
GCATCGAATTAATTGTGCCGAGCG -> CATCGAATTAATTGTGCCGAGCGA
GACGGGCTAGTAAACTGCGAAATA -> ACGGGCTAGTAAACTGCGAAATAA
ATCCAGAACCCTGAATAACAGGGC -> TCCAGAACCCTGAATAACAGGGCA
GTGCCGAGCGACAGCGAAGCAGTT -> TGCCGAGCGACAGCGAAGCAGTTA
ATTAAACTAACTCAATGAGGAATA -> TTAAACTAACTCAATGAGGAATAG
AACTTCACCCTAGGGTCGACCTCT -> ACTTCACCCTAGGGTCGACCTCTG
TAGGAATAGAGTTAATCTATGAAT -> AGGAATAGAGTTAATCTATGAATG
ATCTGTTAGGTACACCTTCTCTTG -> TCTGTTAGGTACACCTTCTCTTGT
AATAGAGTTAATCTATGAATGTCC -> ATAGAGTTAATCTATGAATGTCCA
TACGAAAGTGCTAGCGATAGGTCA -> ACGAAAGTGCTAGCGATAGGTCAT
CCATAGTCTGACAGGTGGCTCAGG -> CATAGTCTGACAGGTGGCTCAGGT
ACGTTGTCTATTGGCACCGAATAC -> CGTTGTCTATTGGCACCGAATACC
TCAAATTCCGATCTCTCACTTGAT -> CAAATTCCGATCTCTCACTTGATT
GCCCTCCCCCTGAGGTTGAAAAAT -> CCCTCCCCCTGAGGTTGAAAAATT
CTTGCTACTGCCATGTTTGCTTCT -> TTGCTACTGCCATGTTTGCTTCTC
GCTCTTGGGAAGTTAGAGATGGCT -> CTCTTGGGAAGTTAGAGATGGCTC
GAATACCGAACATTGCGACAGTGA -> AATACCGAACATTGCGACAGTGAT
GGGGGCTCTTGGGAAGTTAGAGAT -> GGGGCTCTTGGGAAGTTAGAGATG
ATATAGTCGACGCTACTACGGTAG -> TATAGTCGACGCTACTACGGTAGC
ACAATGCCCCATGCCCTCGAGTGG -> CAATGCCCCATGCCCTCGAGTGGA
TATGCCGGTAATTTCTCGTGGCCT -> ATGCCGGTAATTTCTCGTGGCCTA
GGCAGCTTTGAGCGCACAGAAATA -> GCAGCTTTGAGCGCACAGAAATAT
CAATGAGCGCTGCTTCCCTCCGTC -> AATGAGCGCTGCTTCCCTCCGTCC
GCACCAGACGTTCATGCCCTGGTG -> CACCAGACGTTCATGCCCTGGTGG
TACATGTCCGGGGAGATTGCCTCT -> ACATGTCCGGGGAGATTGCCTCTT
CACTTGATTAAATCCAGAACCCTG -> ACTTGATTAAATCCAGAACCCTGA
AGGTCATCAAGAAAGGCCCAGTGC -> GGTCATCAAGAAAGGCCCAGTGCA
CTTACGCTTAATCCCACCATCGTT -> TTACGCTTAATCCCACCATCGTTA
GCCGCCCGGGCCCGGCAAGGCCTC -> CCGCCCGGGCCCGGCAAGGCCTCT
AACAGGGCACTGCGCAGAATCCTG -> ACAGGGCACTGCGCAGAATCCTGA
CCGAGCGACAGCGAAGCAGTTAAT -> CGAGCGACAGCGAAGCAGTTAATA
AGTTTGGAGTCAGAGAATTACGTA -> GTTTGGAGTCAGAGAATTACGTAT
ACAGTCTGAGAAAGTTTGGAGTCA -> CAGTCTGAGAAAGTTTGGAGTCAG
CACCAGACGTTCATGCCCTGGTGG -> ACCAGACGTTCATGCCCTGGTGGC
CATCGAATTAATTGTGCCGAGCGA -> ATCGAATTAATTGTGCCGAGCGAC
CACACACGTTTTACAGGTCGATAC -> ACACACGTTTTACAGGTCGATACG
ACATTGCCGGAACTATAGGAATAG -> CATTGCCGGAACTATAGGAATAGA
ATAGGTCATCAAGAAAGGCCCAGT -> TAGGTCATCAAGAAAGGCCCAGTG
AAAGGGATCTGAGACGCAGCAATG -> AAGGGATCTGAGACGCAGCAATGT
GCCCTCGAGTGGAGGGGGCTCTTG -> CCCTCGAGTGGAGGGGGCTCTTGG
CCGCCCGGGCCCGGCAAGGCCTCT -> CGCCCGGGCCCGGCAAGGCCTCTT
CAATGTGGCTCTTCTATTTGAGGC -> AATGTGGCTCTTCTATTTGAGGCA
CTTAAGCTACTAAAGAACCAGGTC -> TTAAGCTACTAAAGAACCAGGTCA
CCGTGGACACTTGCTACTGCCATG -> CGTGGACACTTGCTACTGCCATGT
ACTAAAGAACCAGGTCAGCCGACA -> CTAAAGAACCAGGTCAGCCGACAA
GCTGCTACTCACCTTAATTAATGC -> CTGCTACTCACCTTAATTAATGCA
TCAGCATCGAATTAATTGTGCCGA -> CAGCATCGAATTAATTGTGCCGAG
TGCACCAGACGTTCATGCCCTGGT -> GCACCAGACGTTCATGCCCTGGTG
TGAGCTCTTACGCTTAATCCCACC -> GAGCTCTTACGCTTAATCCCACCA
TATAGGAATAGAGTTAATCTATGA -> ATAGGAATAGAGTTAATCTATGAA
